"행정구역별(읍면동)","연령별","시점","총인구(명)","총인구_남자(명)","총인구_여자(명)","총인구_성비","내국인(명)","내국인_남자(명)","내국인_여자(명)","내국인_성비",
"전국","합계","2015 년","51069375","25608502","25460873","100.6","49705663","24819839","24885824","99.7",
"전국","합계","2016 년","51269554","25696987","25572567","100.5","49855796","24881520","24974276","99.6",
"전국","합계","2017 년","51422507","25768055","25654452","100.4","49943260","24922392","25020868","99.6",
"전국","합계","2018 년","51629512","25877195","25752317","100.5","49977951","24931554","25046397","99.5",
"전국","합계","2019 년","51779203","25952070","25827133","100.5","50000285","24934662","25065623","99.5",
"전국","합계","2020 년","51829136","25915207","25913929","100","50133493","24972588","25160905","99.3",
"전국","합계","2021 년","51738071","25850044","25888027","99.9","50088104","24943537","25144567","99.2",
"전국","합계","2022 년","51692272","25835298","25856974","99.9","49939926","24866514","25073412","99.2",
"전국","합계","2023 년","51774521","25903852","25870669","100.1","49839371","24810723","25028648","99.1",
"전국","0~4세","2015 년","2258670","1159011","1099659","105.4","2235397","1147126","1088271","105.4",
"전국","0~4세","2016 년","2218378","1137155","1081223","105.2","2192603","1124012","1068591","105.2",
"전국","0~4세","2017 년","2102959","1077714","1025245","105.1","2075937","1064016","1011921","105.1",
"전국","0~4세","2018 년","2000217","1025394","974823","105.2","1967942","1008953","958989","105.2",
"전국","0~4세","2019 년","1881548","965211","916337","105.3","1841730","944850","896880","105.3",
"전국","0~4세","2020 년","1722081","883196","838885","105.3","1684917","864276","820641","105.3",
"전국","0~4세","2021 년","1570409","805852","764557","105.4","1536204","788406","747798","105.4",
"전국","0~4세","2022 년","1459301","748056","711245","105.2","1426032","731063","694969","105.2",
"전국","0~4세","2023 년","1361737","697702","664035","105.1","1331363","682180","649183","105.1",
"전국","5~9세","2015 년","2267851","1169770","1098081","106.5","2252950","1162087","1090863","106.5",
"전국","5~9세","2016 년","2304689","1187031","1117658","106.2","2287123","1177879","1109244","106.2",
"전국","5~9세","2017 년","2303030","1185280","1117750","106","2287878","1177479","1110399","106",
"전국","5~9세","2018 년","2279824","1172145","1107679","105.8","2261032","1162616","1098416","105.8",
"전국","5~9세","2019 년","2276617","1168966","1107651","105.5","2251185","1156094","1095091","105.6",
"전국","5~9세","2020 년","2264595","1161247","1103348","105.2","2238916","1148248","1090668","105.3",
"전국","5~9세","2021 년","2212372","1133426","1078946","105","2180368","1117345","1063023","105.1",
"전국","5~9세","2022 년","2095594","1073564","1022030","105","2060530","1055963","1004567","105.1",
"전국","5~9세","2023 년","1980026","1014945","965081","105.2","1949720","999638","950082","105.2",
"전국","10~14세","2015 년","2427792","1262770","1165022","108.4","2418360","1257902","1160458","108.4",
"전국","10~14세","2016 년","2299146","1193915","1105231","108","2288612","1188475","1100137","108",
"전국","10~14세","2017 년","2276763","1178964","1097799","107.4","2267947","1174461","1093486","107.4",
"전국","10~14세","2018 년","2262767","1169008","1093759","106.9","2250907","1163024","1087883","106.9",
"전국","10~14세","2019 년","2234015","1152447","1081568","106.6","2219036","1144862","1074174","106.6",
"전국","10~14세","2020 년","2267481","1168937","1098544","106.4","2252113","1161098","1091015","106.4",
"전국","10~14세","2021 년","2304690","1186319","1118371","106.1","2286676","1177079","1109597","106.1",
"전국","10~14세","2022 년","2305033","1185794","1119239","105.9","2283668","1174962","1108706","106",
"전국","10~14세","2023 년","2277663","1170779","1106884","105.8","2255118","1159359","1095759","105.8",
"전국","15~19세","2015 년","3194079","1668683","1525396","109.4","3170545","1657722","1512823","109.6",
"전국","15~19세","2016 년","3084039","1606802","1477237","108.8","3056728","1594229","1462499","109",
"전국","15~19세","2017 년","2922140","1523741","1398399","109","2891577","1509599","1381978","109.2",
"전국","15~19세","2018 년","2772966","1445280","1327686","108.9","2735274","1427114","1308160","109.1",
"전국","15~19세","2019 년","2637341","1371661","1265680","108.4","2595613","1352018","1243595","108.7",
"전국","15~19세","2020 년","2449561","1271404","1178157","107.9","2422002","1258885","1163117","108.2",
"전국","15~19세","2021 년","2313299","1198911","1114388","107.6","2288333","1187703","1100630","107.9",
"전국","15~19세","2022 년","2303446","1190769","1112677","107","2266980","1173549","1093431","107.3",
"전국","15~19세","2023 년","2298339","1186270","1112069","106.7","2252391","1163494","1088897","106.9",
"전국","20~24세","2015 년","3531108","1887776","1643332","114.9","3385936","1808857","1577079","114.7",
"전국","20~24세","2016 년","3552780","1898134","1654646","114.7","3400634","1816165","1584469","114.6",
"전국","20~24세","2017 년","3517690","1872652","1645038","113.8","3355986","1786645","1569341","113.8",
"전국","20~24세","2018 년","3484744","1851798","1632946","113.4","3290233","1744884","1545349","112.9",
"전국","20~24세","2019 년","3413656","1806316","1607340","112.4","3203741","1690943","1512798","111.8",
"전국","20~24세","2020 년","3364804","1762135","1602669","110","3193316","1670636","1522680","109.7",
"전국","20~24세","2021 년","3223654","1681183","1542471","109","3066118","1602890","1463228","109.5",
"전국","20~24세","2022 년","3054220","1597071","1457149","109.6","2879013","1509973","1369040","110.3",
"전국","20~24세","2023 년","2915658","1529757","1385901","110.4","2715480","1423937","1291543","110.3",
"전국","25~29세","2015 년","3265288","1728888","1536400","112.5","3027896","1581887","1446009","109.4",
"전국","25~29세","2016 년","3308184","1756218","1551966","113.2","3068970","1607473","1461497","110",
"전국","25~29세","2017 년","3407757","1815686","1592071","114","3164039","1665093","1498946","111.1",
"전국","25~29세","2018 년","3520222","1884327","1635895","115.2","3259284","1721877","1537407","112",
"전국","25~29세","2019 년","3612505","1938641","1673864","115.8","3343423","1771185","1572238","112.7",
"전국","25~29세","2020 년","3666212","1959723","1706489","114.8","3423231","1813896","1609335","112.7",
"전국","25~29세","2021 년","3663127","1954718","1708409","114.4","3439492","1822691","1616801","112.7",
"전국","25~29세","2022 년","3622860","1930682","1692178","114.1","3384426","1787742","1596684","112",
"전국","25~29세","2023 년","3579935","1907333","1672602","114","3310331","1741244","1569087","111",
"전국","30~34세","2015 년","3811610","1986796","1824814","108.9","3611034","1854905","1756129","105.6",
"전국","30~34세","2016 년","3629317","1894497","1734820","109.2","3415599","1756053","1659546","105.8",
"전국","30~34세","2017 년","3447773","1804860","1642913","109.9","3216057","1657296","1558761","106.3",
"전국","30~34세","2018 년","3339755","1755850","1583905","110.9","3080835","1592897","1487938","107.1",
"전국","30~34세","2019 년","3304679","1745076","1559603","111.9","3029678","1573520","1456158","108.1",
"전국","30~34세","2020 년","3301331","1742483","1558848","111.8","3032832","1579900","1452932","108.7",
"전국","30~34세","2021 년","3332272","1759768","1572504","111.9","3080905","1609294","1471611","109.4",
"전국","30~34세","2022 년","3435308","1825651","1609657","113.4","3179338","1668917","1510421","110.5",
"전국","30~34세","2023 년","3557870","1905868","1652002","115.4","3273995","1725797","1548198","111.5",
"전국","35~39세","2015 년","3926862","2022466","1904396","106.2","3783589","1927388","1856201","103.8",
"전국","35~39세","2016 년","4002467","2062739","1939728","106.3","3852007","1963865","1888142","104",
"전국","35~39세","2017 년","4070681","2100211","1970470","106.6","3904372","1992903","1911469","104.3",
"전국","35~39세","2018 년","4106922","2120795","1986127","106.8","3915428","1999417","1916011","104.4",
"전국","35~39세","2019 년","3999744","2070152","1929592","107.3","3791256","1939621","1851635","104.8",
"전국","35~39세","2020 년","3805470","1970249","1835221","107.4","3594213","1841713","1752500","105.1",
"전국","35~39세","2021 년","3622347","1877724","1744623","107.6","3408007","1748821","1659186","105.4",
"전국","35~39세","2022 년","3437364","1788398","1648966","108.5","3210198","1650898","1559300","105.9",
"전국","35~39세","2023 년","3333907","1745532","1588375","109.9","3076302","1587340","1488962","106.6",
"전국","40~44세","2015 년","4338827","2218442","2120385","104.6","4215921","2142101","2073820","103.3",
"전국","40~44세","2016 년","4152420","2124144","2028276","104.7","4031799","2049032","1982767","103.3",
"전국","40~44세","2017 년","4037048","2060634","1976414","104.3","3916382","1986538","1929844","102.9",
"전국","40~44세","2018 년","3910064","2001842","1908222","104.9","3775918","1920059","1855859","103.5",
"전국","40~44세","2019 년","3855403","1974200","1881203","104.9","3707290","1884344","1822946","103.4",
"전국","40~44세","2020 년","3906665","1997630","1909035","104.6","3758298","1909518","1848780","103.3",
"전국","40~44세","2021 년","3981710","2038116","1943594","104.9","3831323","1949291","1882032","103.6",
"전국","40~44세","2022 년","4047796","2075221","1972575","105.2","3883866","1978627","1905239","103.9",
"전국","40~44세","2023 년","4083172","2097082","1986090","105.6","3897378","1987030","1910348","104",
"전국","45~49세","2015 년","4388157","2217013","2171144","102.1","4266941","2151070","2115871","101.7",
"전국","45~49세","2016 년","4492909","2264120","2228789","101.6","4369603","2196126","2173477","101",
"전국","45~49세","2017 년","4532957","2295736","2237221","102.6","4404427","2224798","2179629","102.1",
"전국","45~49세","2018 년","4498819","2282577","2216242","103","4362254","2206233","2156021","102.3",
"전국","45~49세","2019 년","4449226","2263200","2186026","103.5","4307141","2182319","2124822","102.7",
"전국","45~49세","2020 년","4325697","2196042","2129655","103.1","4195327","2123611","2071716","102.5",
"전국","45~49세","2021 년","4134223","2100431","2033792","103.3","4010015","2030757","1979258","102.6",
"전국","45~49세","2022 년","4018684","2037952","1980732","102.9","3895813","1969118","1926695","102.2",
"전국","45~49세","2023 년","3894494","1981666","1912828","103.6","3760451","1906606","1853845","102.8",
"전국","50~54세","2015 년","4263447","2153186","2110261","102","4145976","2094318","2051658","102.1",
"전국","50~54세","2016 년","4153936","2108614","2045322","103.1","4030564","2045888","1984676","103.1",
"전국","50~54세","2017 년","4122551","2082358","2040193","102.1","4000764","2020278","1980486","102",
"전국","50~54세","2018 년","4196221","2109486","2086735","101.1","4071272","2044989","2026283","100.9",
"전국","50~54세","2019 년","4322368","2170535","2151833","100.9","4191706","2101302","2090404","100.5",
"전국","50~54세","2020 년","4372054","2195060","2176994","100.8","4245683","2130025","2115658","100.7",
"전국","50~54세","2021 년","4477633","2243979","2233654","100.5","4350920","2177577","2173343","100.2",
"전국","50~54세","2022 년","4513276","2273280","2239996","101.5","4380778","2202871","2177907","101.1",
"전국","50~54세","2023 년","4482461","2262196","2220265","101.9","4342725","2187336","2155389","101.5",
"전국","55~59세","2015 년","3956849","1969232","1987617","99.1","3863095","1922796","1940299","99.1",
"전국","55~59세","2016 년","4165508","2069976","2095532","98.8","4076050","2025701","2050349","98.8",
"전국","55~59세","2017 년","4258232","2120781","2137451","99.2","4167356","2076215","2091141","99.3",
"전국","55~59세","2018 년","4319504","2154401","2165103","99.5","4212132","2101462","2110670","99.6",
"전국","55~59세","2019 년","4285702","2143941","2141761","100.1","4167929","2084851","2083078","100.1",
"전국","55~59세","2020 년","4210645","2109380","2101265","100.4","4091920","2051221","2040699","100.5",
"전국","55~59세","2021 년","4097916","2064943","2032973","101.6","3976114","2004426","1971688","101.7",
"전국","55~59세","2022 년","4076219","2044571","2031648","100.6","3955115","1984188","1970927","100.7",
"전국","55~59세","2023 년","4153074","2073954","2079120","99.8","4030747","2012265","2018482","99.7",
"전국","60~64세","2015 년","2821457","1379694","1441763","95.7","2758941","1348273","1410668","95.6",
"전국","60~64세","2016 년","3079213","1508112","1571101","96","3010386","1473557","1536829","95.9",
"전국","60~64세","2017 년","3251699","1596954","1654745","96.5","3175172","1558672","1616500","96.4",
"전국","60~64세","2018 년","3482338","1715950","1766388","97.1","3401325","1675784","1725541","97.1",
"전국","60~64세","2019 년","3689408","1816973","1872435","97","3604994","1775178","1829816","97",
"전국","60~64세","2020 년","3885297","1912792","1972505","97","3795217","1869359","1925858","97.1",
"전국","60~64세","2021 년","4097858","2016321","2081537","96.9","4013702","1975945","2037757","97",
"전국","60~64세","2022 년","4176683","2058253","2118430","97.2","4088069","2015906","2072163","97.3",
"전국","60~64세","2023 년","4247204","2098812","2148392","97.7","4146695","2050544","2096151","97.8",
"전국","65~69세","2015 년","2144023","1028129","1115894","92.1","2117875","1015463","1102412","92.1",
"전국","65~69세","2016 년","2208535","1058989","1149546","92.1","2179524","1044970","1134554","92.1",
"전국","65~69세","2017 년","2315195","1113374","1201821","92.6","2282138","1097501","1184637","92.6",
"전국","65~69세","2018 년","2372155","1139381","1232774","92.4","2335461","1121855","1213606","92.4",
"전국","65~69세","2019 년","2492232","1199690","1292542","92.8","2450215","1179719","1270496","92.9",
"전국","65~69세","2020 년","2734187","1314575","1419612","92.6","2685773","1291921","1393852","92.7",
"전국","65~69세","2021 년","2976607","1433783","1542824","92.9","2925766","1409896","1515870","93",
"전국","65~69세","2022 년","3144288","1519093","1625195","93.5","3086282","1491675","1594607","93.5",
"전국","65~69세","2023 년","3367282","1632277","1735005","94.1","3304593","1602931","1701662","94.2",
"전국","70~74세","2015 년","1770741","793855","976886","81.3","1760932","789607","971325","81.3",
"전국","70~74세","2016 년","1746223","790608","955615","82.7","1736294","786401","949893","82.8",
"전국","70~74세","2017 년","1756166","802127","954039","84.1","1745402","797640","947762","84.2",
"전국","70~74세","2018 년","1829392","844189","985203","85.7","1817370","839242","978128","85.8",
"전국","70~74세","2019 년","1926601","896925","1029676","87.1","1911438","890402","1021036","87.2",
"전국","70~74세","2020 년","2027679","946539","1081140","87.6","2009542","938910","1070632","87.7",
"전국","70~74세","2021 년","2089644","975415","1114229","87.5","2069571","966856","1102715","87.7",
"전국","70~74세","2022 년","2193238","1026934","1166304","88.1","2169182","1016612","1152570","88.2",
"전국","70~74세","2023 년","2252925","1054423","1198502","88","2224925","1042514","1182411","88.2",
"전국","75~79세","2015 년","1362669","553178","809491","68.3","1356014","550684","805330","68.4",
"전국","75~79세","2016 년","1425031","585602","839429","69.8","1418480","583304","835176","69.8",
"전국","75~79세","2017 년","1543849","643508","900341","71.5","1537367","641422","895945","71.6",
"전국","75~79세","2018 년","1585750","666909","918841","72.6","1579289","664879","914410","72.7",
"전국","75~79세","2019 년","1595168","676049","919119","73.6","1588073","673589","914484","73.7",
"전국","75~79세","2020 년","1600867","684291","916576","74.7","1593192","681766","911426","74.8",
"전국","75~79세","2021 년","1584604","685723","898881","76.3","1576830","683137","893693","76.4",
"전국","75~79세","2022 년","1598274","699921","898353","77.9","1588867","696679","892188","78.1",
"전국","75~79세","2023 년","1670946","740365","930581","79.6","1659823","736481","923342","79.8",
"전국","80~84세","2015 년","814222","276627","537595","51.5","810891","275462","535429","51.4",
"전국","80~84세","2016 년","884261","307499","576762","53.3","880699","306320","574379","53.3",
"전국","80~84세","2017 년","943418","335345","608073","55.1","939787","334274","605513","55.2",
"전국","80~84세","2018 년","1005673","363891","641782","56.7","1001715","362776","638939","56.8",
"전국","80~84세","2019 년","1075010","396231","678779","58.4","1070623","394900","675723","58.4",
"전국","80~84세","2020 년","1120781","419037","701744","59.7","1115804","417754","698050","59.8",
"전국","80~84세","2021 년","1178836","447622","731214","61.2","1173715","446293","727422","61.4",
"전국","80~84세","2022 년","1280639","494021","786618","62.8","1274965","492514","782451","62.9",
"전국","80~84세","2023 년","1319730","514355","805375","63.9","1313292","512561","800731","64",
"전국","85~89세","2015 년","372987","98855","274132","36.1","371527","98367","273160","36",
"전국","85~89세","2016 년","400337","107281","293056","36.6","398827","106818","292009","36.6",
"전국","85~89세","2017 년","434947","119540","315407","37.9","433550","119129","314421","37.9",
"전국","85~89세","2018 년","467681","132006","335675","39.3","466247","131650","334597","39.3",
"전국","85~89세","2019 년","511197","148298","362899","40.9","509347","147716","361631","40.8",
"전국","85~89세","2020 년","563930","168643","395287","42.7","562068","168181","393887","42.7",
"전국","85~89세","2021 년","617681","189457","428224","44.2","615617","188955","426662","44.3",
"전국","85~89세","2022 년","654226","204915","449311","45.6","651839","204318","447521","45.7",
"전국","85~89세","2023 년","699992","223396","476596","46.9","696978","222595","474383","46.9",
"전국","90~94세","2015 년","124723","28759","95964","30","124111","28565","95546","29.9",
"전국","90~94세","2016 년","130627","29532","101095","29.2","130010","29346","100664","29.2",
"전국","90~94세","2017 년","141555","31590","109965","28.7","141169","31488","109681","28.7",
"전국","90~94세","2018 년","153410","33938","119472","28.4","153039","33849","119190","28.4",
"전국","90~94세","2019 년","173427","38990","134437","29","172793","38783","134010","28.9",
"전국","90~94세","2020 년","192663","42951","149712","28.7","192149","42825","149324","28.7",
"전국","90~94세","2021 년","208758","47148","161610","29.2","208193","47024","161169","29.2",
"전국","90~94세","2022 년","222922","51674","171248","30.2","222263","51519","170744","30.2",
"전국","90~94세","2023 년","239881","56865","183016","31.1","239060","56662","182398","31.1",
"전국","95~99세","2015 년","24796","4923","19873","24.8","24573","4831","19742","24.5",
"전국","95~99세","2016 년","28007","5550","22457","24.7","27798","5461","22337","24.4",
"전국","95~99세","2017 년","32154","6435","25719","25","32045","6395","25650","24.9",
"전국","95~99세","2018 년","36839","7427","29412","25.3","36762","7402","29360","25.2",
"전국","95~99세","2019 년","38482","7760","30722","25.3","38255","7683","30572","25.1",
"전국","95~99세","2020 년","41512","8024","33488","24","41399","7995","33404","23.9",
"전국","95~99세","2021 년","43868","8149","35719","22.8","43717","8116","35601","22.8",
"전국","95~99세","2022 년","45930","8357","37573","22.2","45780","8320","37460","22.2",
"전국","95~99세","2023 년","50591","8977","41614","21.6","50438","8938","41500","21.5",
"전국","100세이상","2015 년","3217","449","2768","16.2","3159","428","2731","15.7",
"전국","100세이상","2016 년","3547","469","3078","15.2","3486","445","3041","14.6",
"전국","100세이상","2017 년","3943","565","3378","16.7","3908","550","3358","16.4",
"전국","100세이상","2018 년","4249","601","3648","16.5","4232","592","3640","16.3",
"전국","100세이상","2019 년","4874","808","4066","19.9","4819","783","4036","19.4",
"전국","100세이상","2020 년","5624","869","4755","18.3","5581","850","4731","18",
"전국","100세이상","2021 년","6563","1056","5507","19.2","6518","1035","5483","18.9",
"전국","100세이상","2022 년","6971","1121","5850","19.2","6922","1100","5822","18.9",
"전국","100세이상","2023 년","7634","1298","6336","20.5","7566","1271","6295","20.2",
"전국","15세미만","2015 년","6954313","3591551","3362762","106.8","6906707","3567115","3339592","106.8",
"전국","15세미만","2016 년","6822213","3518101","3304112","106.5","6768338","3490366","3277972","106.5",
"전국","15세미만","2017 년","6682752","3441958","3240794","106.2","6631762","3415956","3215806","106.2",
"전국","15세미만","2018 년","6542808","3366547","3176261","106","6479881","3334593","3145288","106",
"전국","15세미만","2019 년","6392180","3286624","3105556","105.8","6311951","3245806","3066145","105.9",
"전국","15세미만","2020 년","6254157","3213380","3040777","105.7","6175946","3173622","3002324","105.7",
"전국","15세미만","2021 년","6087471","3125597","2961874","105.5","6003248","3082830","2920418","105.6",
"전국","15세미만","2022 년","5859928","3007414","2852514","105.4","5770230","2961988","2808242","105.5",
"전국","15세미만","2023 년","5619426","2883426","2736000","105.4","5536201","2841177","2695024","105.4",
"전국","15~64세","2015 년","37497684","19232176","18265508","105.3","36229874","18489317","17740557","104.2",
"전국","15~64세","2016 년","37620773","19293356","18327417","105.3","36312340","18528089","17784251","104.2",
"전국","15~64세","2017 년","37568528","19273613","18294915","105.3","36196132","18478037","17718095","104.3",
"전국","15~64세","2018 년","37631555","19322306","18309249","105.5","36103955","18434716","17669239","104.3",
"전국","15~64세","2019 년","37570032","19300695","18269337","105.6","35942771","18355281","17587490","104.4",
"전국","15~64세","2020 년","37287736","19116898","18170838","105.2","35752039","18248764","17503275","104.3",
"전국","15~64세","2021 년","36944039","18936094","18007945","105.2","35464929","18109395","17355534","104.3",
"전국","15~64세","2022 년","36685856","18821848","17864008","105.4","35123596","17941789","17181807","104.4",
"전국","15~64세","2023 년","36546114","18788470","17757644","105.8","34806495","17785593","17020902","104.5",
"전국","65세이상","2015 년","6617378","2784775","3832603","72.7","6569082","2763407","3805675","72.6",
"전국","65세이상","2016 년","6826568","2885530","3941038","73.2","6775118","2863065","3912053","73.2",
"전국","65세이상","2017 년","7171227","3052484","4118743","74.1","7115366","3028399","4086967","74.1",
"전국","65세이상","2018 년","7455149","3188342","4266807","74.7","7394115","3162245","4231870","74.7",
"전국","65세이상","2019 년","7816991","3364751","4452240","75.6","7745563","3333575","4411988","75.6",
"전국","65세이상","2020 년","8287243","3584929","4702314","76.2","8205508","3550202","4655306","76.3",
"전국","65세이상","2021 년","8706561","3788353","4918208","77","8619927","3751312","4868615","77.1",
"전국","65세이상","2022 년","9146488","4006036","5140452","77.9","9046100","3962737","5083363","78",
"전국","65세이상","2023 년","9608981","4231956","5377025","78.7","9496675","4183953","5312722","78.8",
"전국","85세이상","2015 년","525723","132986","392737","33.9","523370","132191","391179","33.8",
"전국","85세이상","2016 년","562518","142832","419686","34","560121","142070","418051","34",
"전국","85세이상","2017 년","612599","158130","454469","34.8","610672","157562","453110","34.8",
"전국","85세이상","2018 년","662179","173972","488207","35.6","660280","173493","486787","35.6",
"전국","85세이상","2019 년","727980","195856","532124","36.8","725214","194965","530249","36.8",
"전국","85세이상","2020 년","803729","220487","583242","37.8","801197","219851","581346","37.8",
"전국","85세이상","2021 년","876870","245810","631060","39","874045","245130","628915","39",
"전국","85세이상","2022 년","930049","266067","663982","40.1","926804","265257","661547","40.1",
"전국","85세이상","2023 년","998098","290536","707562","41.1","994042","289466","704576","41.1",
"전국","평균연령","2015 년","40.4","39.2","41.6","","40.4","39.2","41.6","",
"전국","평균연령","2016 년","40.8","39.6","42","","40.9","39.7","42.1","",
"전국","평균연령","2017 년","41.3","40.1","42.5","","41.4","40.2","42.6","",
"전국","평균연령","2018 년","41.8","40.6","43","","42","40.8","43.2","",
"전국","평균연령","2019 년","42.4","41.2","43.6","","42.5","41.3","43.7","",
"전국","평균연령","2020 년","42.9","41.7","44.1","","43.1","41.9","44.2","",
"전국","평균연령","2021 년","43.5","42.3","44.7","","43.6","42.5","44.8","",
"전국","평균연령","2022 년","44","42.8","45.2","","44.2","43","45.4","",
"전국","평균연령","2023 년","44.6","43.4","45.8","","44.8","43.6","46","",
"전국","중위연령","2015 년","41.1","39.8","42.3","","41.2","40","42.4","",
"전국","중위연령","2016 년","41.6","40.3","42.9","","41.8","40.6","43","",
"전국","중위연령","2017 년","42.2","40.8","43.5","","42.4","41.2","43.7","",
"전국","중위연령","2018 년","42.7","41.3","44.1","","43.1","41.8","44.3","",
"전국","중위연령","2019 년","43.3","41.9","44.7","","43.7","42.4","45","",
"전국","중위연령","2020 년","43.9","42.5","45.3","","44.3","42.9","45.6","",
"전국","중위연령","2021 년","44.5","43.1","46","","44.9","43.6","46.3","",
"전국","중위연령","2022 년","45.1","43.7","46.6","","45.5","44.2","46.9","",
"전국","중위연령","2023 년","45.7","44.3","47.2","","46.2","44.8","47.6","",
"읍부","합계","2015 년","4616802","2360708","2256094","104.6","4467697","2262853","2204844","102.6",
"읍부","합계","2016 년","4707855","2410964","2296891","105","4548051","2305977","2242074","102.9",
"읍부","합계","2017 년","4794377","2456558","2337819","105.1","4625994","2347613","2278381","103",
"읍부","합계","2018 년","4984023","2557807","2426216","105.4","4787535","2431315","2356220","103.2",
"읍부","합계","2019 년","5057507","2599416","2458091","105.7","4839016","2459087","2379929","103.3",
"읍부","합계","2020 년","5113052","2624351","2488701","105.5","4904647","2494271","2410376","103.5",
"읍부","합계","2021 년","5183834","2658474","2525360","105.3","4977540","2531672","2445868","103.5",
"읍부","합계","2022 년","5098892","2621409","2477483","105.8","4879206","2484040","2395166","103.7",
"읍부","합계","2023 년","5131418","2647996","2483422","106.6","4876488","2484268","2392220","103.8",
"읍부","0~4세","2015 년","233564","119732","113832","105.2","231988","118904","113084","105.1",
"읍부","0~4세","2016 년","231080","118454","112626","105.2","229170","117486","111684","105.2",
"읍부","0~4세","2017 년","221651","113569","108082","105.1","219516","112485","107031","105.1",
"읍부","0~4세","2018 년","216349","110635","105714","104.7","213614","109246","104368","104.7",
"읍부","0~4세","2019 년","203163","104195","98968","105.3","199442","102293","97149","105.3",
"읍부","0~4세","2020 년","186397","95478","90919","105","182784","93679","89105","105.1",
"읍부","0~4세","2021 년","173499","88943","84556","105.2","169742","87046","82696","105.3",
"읍부","0~4세","2022 년","154701","79214","75487","104.9","150945","77326","73619","105",
"읍부","0~4세","2023 년","141204","72499","68705","105.5","137522","70632","66890","105.6",
"읍부","5~9세","2015 년","235248","121405","113843","106.6","234270","120942","113328","106.7",
"읍부","5~9세","2016 년","242073","124716","117357","106.3","240812","124092","116720","106.3",
"읍부","5~9세","2017 년","245733","126546","119187","106.2","244499","125930","118569","106.2",
"읍부","5~9세","2018 년","250189","128579","121610","105.7","248434","127696","120738","105.8",
"읍부","5~9세","2019 년","250511","128663","121848","105.6","247997","127415","120582","105.7",
"읍부","5~9세","2020 년","249655","128260","121395","105.7","247086","126979","120107","105.7",
"읍부","5~9세","2021 년","247952","127247","120705","105.4","244490","125516","118974","105.5",
"읍부","5~9세","2022 년","228819","117501","111318","105.6","224991","115581","109410","105.6",
"읍부","5~9세","2023 년","214005","109878","104127","105.5","210579","108157","102422","105.6",
"읍부","10~14세","2015 년","237032","123793","113239","109.3","236449","123493","112956","109.3",
"읍부","10~14세","2016 년","228463","119090","109373","108.9","227743","118702","109041","108.9",
"읍부","10~14세","2017 년","230801","119896","110905","108.1","230031","119497","110534","108.1",
"읍부","10~14세","2018 년","238628","123679","114949","107.6","237447","123090","114357","107.6",
"읍부","10~14세","2019 년","239851","123990","115861","107","238245","123181","115064","107.1",
"읍부","10~14세","2020 년","246197","127178","119019","106.9","244554","126323","118231","106.8",
"읍부","10~14세","2021 년","256517","132293","124224","106.5","254468","131258","123210","106.5",
"읍부","10~14세","2022 년","254579","131272","123307","106.5","252128","130021","122107","106.5",
"읍부","10~14세","2023 년","251574","129520","122054","106.1","248916","128160","120756","106.1",
"읍부","15~19세","2015 년","295147","155461","139686","111.3","293453","154560","138893","111.3",
"읍부","15~19세","2016 년","292438","153211","139227","110","290304","152114","138190","110.1",
"읍부","15~19세","2017 년","282010","148406","133604","111.1","279503","147162","132341","111.2",
"읍부","15~19세","2018 년","280768","147357","133411","110.5","277076","145504","131572","110.6",
"읍부","15~19세","2019 년","271740","142387","129353","110.1","267482","140165","127317","110.1",
"읍부","15~19세","2020 년","254413","133108","121305","109.7","251867","131863","120004","109.9",
"읍부","15~19세","2021 년","245513","128292","117221","109.4","243076","127077","115999","109.6",
"읍부","15~19세","2022 년","240233","125716","114517","109.8","236794","123898","112896","109.7",
"읍부","15~19세","2023 년","242136","126727","115409","109.8","237645","124170","113475","109.4",
"읍부","20~24세","2015 년","283961","161109","122852","131.1","266163","149340","116823","127.8",
"읍부","20~24세","2016 년","294795","167499","127296","131.6","276354","155134","121220","128",
"읍부","20~24세","2017 년","296297","167892","128405","130.8","277651","155618","122033","127.5",
"읍부","20~24세","2018 년","307040","175149","131891","132.8","284188","160000","124188","128.8",
"읍부","20~24세","2019 년","304366","173158","131208","132","279923","157014","122909","127.7",
"읍부","20~24세","2020 년","303587","170872","132715","128.8","283532","158185","125347","126.2",
"읍부","20~24세","2021 년","292784","163952","128832","127.3","275913","153985","121928","126.3",
"읍부","20~24세","2022 년","273069","154896","118173","131.1","255181","143628","111553","128.8",
"읍부","20~24세","2023 년","263028","151142","111886","135.1","240075","135647","104428","129.9",
"읍부","25~29세","2015 년","252504","141716","110788","127.9","222057","120275","101782","118.2",
"읍부","25~29세","2016 년","262385","148528","113857","130.5","230096","125669","104427","120.3",
"읍부","25~29세","2017 년","273146","155312","117834","131.8","240135","131934","108201","121.9",
"읍부","25~29세","2018 년","293032","168206","124826","134.8","255080","141262","113818","124.1",
"읍부","25~29세","2019 년","303201","175272","127929","137","262865","146616","116249","126.1",
"읍부","25~29세","2020 년","306699","177841","128858","138","270439","152613","117826","129.5",
"읍부","25~29세","2021 년","309699","179610","130089","138.1","276192","156395","119797","130.6",
"읍부","25~29세","2022 년","302558","176820","125738","140.6","267131","151728","115403","131.5",
"읍부","25~29세","2023 년","304828","179630","125198","143.5","263122","149253","113869","131.1",
"읍부","30~34세","2015 년","326250","174523","151727","115","299599","155087","144512","107.3",
"읍부","30~34세","2016 년","316296","170075","146221","116.3","287223","149019","138204","107.8",
"읍부","30~34세","2017 년","304552","164650","139902","117.7","273223","142532","130691","109.1",
"읍부","30~34세","2018 년","304796","166334","138462","120.1","268383","140958","127425","110.6",
"읍부","30~34세","2019 년","301471","166528","134943","123.4","261216","138604","122612","113",
"읍부","30~34세","2020 년","298316","165241","133075","124.2","259188","138681","120507","115.1",
"읍부","30~34세","2021 년","302753","167899","134854","124.5","265198","142624","122574","116.4",
"읍부","30~34세","2022 년","301560","169711","131849","128.7","262322","142541","119781","119",
"읍부","30~34세","2023 년","314713","180187","134526","133.9","268428","147078","121350","121.2",
"읍부","35~39세","2015 년","364664","191497","173167","110.6","346189","178156","168033","106",
"읍부","35~39세","2016 년","376217","198220","177997","111.4","355974","183681","172293","106.6",
"읍부","35~39세","2017 년","387555","204315","183240","111.5","365362","188629","176733","106.7",
"읍부","35~39세","2018 년","402730","212545","190185","111.8","376135","194267","181868","106.8",
"읍부","35~39세","2019 년","394492","209030","185462","112.7","364452","188553","175899","107.2",
"읍부","35~39세","2020 년","374585","199146","175439","113.5","344010","178758","165252","108.2",
"읍부","35~39세","2021 년","361552","192041","169511","113.3","330229","171444","158785","108",
"읍부","35~39세","2022 년","331510","177364","154146","115.1","298146","155077","143069","108.4",
"읍부","35~39세","2023 년","319426","172958","146468","118.1","280399","146488","133911","109.4",
"읍부","40~44세","2015 년","397077","211651","185426","114.1","382948","202248","180700","111.9",
"읍부","40~44세","2016 년","387692","206146","181546","113.6","373179","196488","176691","111.2",
"읍부","40~44세","2017 년","386407","204514","181893","112.4","371646","194858","176788","110.2",
"읍부","40~44세","2018 년","389756","206081","183675","112.2","372435","194821","177614","109.7",
"읍부","40~44세","2019 년","390080","205613","184467","111.5","370160","192718","177442","108.6",
"읍부","40~44세","2020 년","399895","209952","189943","110.5","379961","197365","182596","108.1",
"읍부","40~44세","2021 년","414946","217814","197132","110.5","393985","204648","189337","108.1",
"읍부","40~44세","2022 년","412332","216073","196259","110.1","389418","201716","187702","107.5",
"읍부","40~44세","2023 년","414466","217704","196762","110.6","387747","200832","186915","107.4",
"읍부","45~49세","2015 년","382526","204010","178516","114.3","370356","197007","173349","113.6",
"읍부","45~49세","2016 년","398257","212049","186208","113.9","385592","204648","180944","113.1",
"읍부","45~49세","2017 년","412234","220028","192206","114.5","398620","212179","186441","113.8",
"읍부","45~49세","2018 년","426891","227506","199385","114.1","411989","218838","193151","113.3",
"읍부","45~49세","2019 년","433622","231468","202154","114.5","417220","221714","195506","113.4",
"읍부","45~49세","2020 년","431875","229425","202450","113.3","416526","220490","196036","112.5",
"읍부","45~49세","2021 년","423114","223975","199139","112.5","407559","214943","192616","111.6",
"읍부","45~49세","2022 년","409509","215731","193778","111.3","393836","206610","187226","110.4",
"읍부","45~49세","2023 년","401252","211443","189809","111.4","383559","201106","182453","110.2",
"읍부","50~54세","2015 년","363818","191640","172178","111.3","353673","186155","167518","111.1",
"읍부","50~54세","2016 년","362043","192220","169823","113.2","351015","186185","164830","113",
"읍부","50~54세","2017 년","365604","193279","172325","112.2","354364","187234","167130","112",
"읍부","50~54세","2018 년","388784","205170","183614","111.7","376747","198656","178091","111.5",
"읍부","50~54세","2019 년","410181","216088","194093","111.3","396816","208746","188070","111",
"읍부","50~54세","2020 년","424592","224058","200534","111.7","411214","216938","194276","111.7",
"읍부","50~54세","2021 년","442283","232770","209513","111.1","428375","225244","203131","110.9",
"읍부","50~54세","2022 년","444065","235140","208925","112.5","429308","227060","202248","112.3",
"읍부","50~54세","2023 년","446491","236376","210115","112.5","430529","227562","202967","112.1",
"읍부","55~59세","2015 년","336333","171825","164508","104.4","329333","168087","161246","104.2",
"읍부","55~59세","2016 년","360848","184595","176253","104.7","353712","180815","172897","104.6",
"읍부","55~59세","2017 년","377475","193949","183526","105.7","369852","190033","179819","105.7",
"읍부","55~59세","2018 년","396889","204485","192404","106.3","388059","199940","188119","106.3",
"읍부","55~59세","2019 년","402412","208649","193763","107.7","392351","203349","189002","107.6",
"읍부","55~59세","2020 년","404659","210357","194302","108.3","394203","205012","189191","108.4",
"읍부","55~59세","2021 년","402417","210599","191818","109.8","391070","204753","186317","109.9",
"읍부","55~59세","2022 년","397447","207526","189921","109.3","385816","201534","184282","109.4",
"읍부","55~59세","2023 년","411136","214390","196746","109","398566","207844","190722","109",
"읍부","60~64세","2015 년","245851","120667","125184","96.4","241683","118459","123224","96.1",
"읍부","60~64세","2016 년","270939","133964","136975","97.8","266168","131438","134730","97.6",
"읍부","60~64세","2017 년","289761","144371","145390","99.3","284398","141507","142891","99",
"읍부","60~64세","2018 년","322574","161389","161185","100.1","316724","158297","158427","99.9",
"읍부","60~64세","2019 년","346874","174227","172647","100.9","340593","171000","169593","100.8",
"읍부","60~64세","2020 년","373293","188250","185043","101.7","366404","184830","181574","101.8",
"읍부","60~64세","2021 년","402239","203112","199127","102","395357","199757","195600","102.1",
"읍부","60~64세","2022 년","408081","207138","200943","103.1","400645","203483","197162","103.2",
"읍부","60~64세","2023 년","419180","213679","205501","104","410532","209442","201090","104.2",
"읍부","65~69세","2015 년","195907","94049","101858","92.3","194124","93145","100979","92.2",
"읍부","65~69세","2016 년","203685","97744","105941","92.3","201640","96711","104929","92.2",
"읍부","65~69세","2017 년","214945","103472","111473","92.8","212701","102344","110357","92.7",
"읍부","65~69세","2018 년","226450","109272","117178","93.3","223904","108015","115889","93.2",
"읍부","65~69세","2019 년","239755","116003","123752","93.7","236735","114491","122244","93.7",
"읍부","65~69세","2020 년","266312","129073","137239","94","262896","127424","135472","94.1",
"읍부","65~69세","2021 년","293061","142975","150086","95.3","289319","141153","148166","95.3",
"읍부","65~69세","2022 년","306342","150574","155768","96.7","301919","148428","153491","96.7",
"읍부","65~69세","2023 년","331102","163745","167357","97.8","326168","161366","164802","97.9",
"읍부","70~74세","2015 년","173777","75758","98019","77.3","173047","75431","97616","77.3",
"읍부","70~74세","2016 년","170077","75542","94535","79.9","169352","75210","94142","79.9",
"읍부","70~74세","2017 년","170212","77370","92842","83.3","169342","76981","92361","83.3",
"읍부","70~74세","2018 년","180545","83594","96951","86.2","179593","83172","96421","86.3",
"읍부","70~74세","2019 년","191446","89773","101673","88.3","190249","89248","101001","88.4",
"읍부","70~74세","2020 년","203017","95534","107483","88.9","201585","94931","106654","89",
"읍부","70~74세","2021 년","211989","99723","112266","88.8","210328","99016","111312","89",
"읍부","70~74세","2022 년","219577","103434","116143","89.1","217646","102614","115032","89.2",
"읍부","70~74세","2023 년","225688","106672","119016","89.6","223420","105704","117716","89.8",
"읍부","75~79세","2015 년","145319","57557","87762","65.6","144884","57385","87499","65.6",
"읍부","75~79세","2016 년","150728","60189","90539","66.5","150254","60010","90244","66.5",
"읍부","75~79세","2017 년","162249","65508","96741","67.7","161787","65348","96439","67.8",
"읍부","75~79세","2018 년","168538","68572","99966","68.6","168073","68426","99647","68.7",
"읍부","75~79세","2019 년","168205","69275","98930","70","167645","69057","98588","70",
"읍부","75~79세","2020 년","168426","70178","98248","71.4","167821","69960","97861","71.5",
"읍부","75~79세","2021 년","166538","70894","95644","74.1","165875","70655","95220","74.2",
"읍부","75~79세","2022 년","164334","71617","92717","77.2","163499","71317","92182","77.4",
"읍부","75~79세","2023 년","170527","75901","94626","80.2","169498","75547","93951","80.4",
"읍부","80~84세","2015 년","89964","29969","59995","50","89770","29897","59873","49.9",
"읍부","80~84세","2016 년","97677","33267","64410","51.6","97463","33186","64277","51.6",
"읍부","80~84세","2017 년","104402","36284","68118","53.3","104157","36192","67965","53.3",
"읍부","80~84세","2018 년","113328","39944","73384","54.4","113039","39853","73186","54.5",
"읍부","80~84세","2019 년","121220","43198","78022","55.4","120897","43094","77803","55.4",
"읍부","80~84세","2020 년","126447","45569","80878","56.3","126062","45455","80607","56.4",
"읍부","80~84세","2021 년","132642","48437","84205","57.5","132228","48317","83911","57.6",
"읍부","80~84세","2022 년","141073","52132","88941","58.6","140611","52000","88611","58.7",
"읍부","80~84세","2023 년","143974","53541","90433","59.2","143413","53369","90044","59.3",
"읍부","85~89세","2015 년","41013","10627","30386","35","40909","10580","30329","34.9",
"읍부","85~89세","2016 년","44135","11555","32580","35.5","44030","11512","32518","35.4",
"읍부","85~89세","2017 년","49235","13011","36224","35.9","49140","12974","36166","35.9",
"읍부","85~89세","2018 년","54260","14721","39539","37.2","54174","14700","39474","37.2",
"읍부","85~89세","2019 년","59597","16665","42932","38.8","59481","16622","42859","38.8",
"읍부","85~89세","2020 년","66273","18980","47293","40.1","66144","18944","47200","40.1",
"읍부","85~89세","2021 년","73162","21493","51669","41.6","73014","21448","51566","41.6",
"읍부","85~89세","2022 년","76145","22749","53396","42.6","75967","22687","53280","42.6",
"읍부","85~89세","2023 년","81016","24501","56515","43.4","80770","24427","56343","43.4",
"읍부","90~94세","2015 년","13755","3150","10605","29.7","13722","3142","10580","29.7",
"읍부","90~94세","2016 년","14481","3224","11257","28.6","14439","3209","11230","28.6",
"읍부","90~94세","2017 년","15940","3385","12555","27","15907","3378","12529","27",
"읍부","90~94세","2018 년","17547","3692","13855","26.6","17519","3681","13838","26.6",
"읍부","90~94세","2019 년","20129","4265","15864","26.9","20083","4248","15835","26.8",
"읍부","90~94세","2020 년","22687","4843","17844","27.1","22654","4835","17819","27.1",
"읍부","90~94세","2021 년","24864","5347","19517","27.4","24827","5339","19488","27.4",
"읍부","90~94세","2022 년","26564","5757","20807","27.7","26519","5750","20769","27.7",
"읍부","90~94세","2023 년","28669","6371","22298","28.6","28612","6358","22254","28.6",
"읍부","95~99세","2015 년","2747","530","2217","23.9","2736","522","2214","23.6",
"읍부","95~99세","2016 년","3153","627","2526","24.8","3141","621","2520","24.6",
"읍부","95~99세","2017 년","3724","751","2973","25.3","3716","748","2968","25.2",
"읍부","95~99세","2018 년","4425","831","3594","23.1","4418","827","3591","23",
"읍부","95~99세","2019 년","4627","880","3747","23.5","4601","870","3731","23.3",
"읍부","95~99세","2020 년","5060","902","4158","21.7","5052","902","4150","21.7",
"읍부","95~99세","2021 년","5496","934","4562","20.5","5483","932","4551","20.5",
"읍부","95~99세","2022 년","5527","916","4611","19.9","5519","915","4604","19.9",
"읍부","95~99세","2023 년","6017","988","5029","19.6","6006","984","5022","19.6",
"읍부","100세이상","2015 년","345","39","306","12.7","344","38","306","12.4",
"읍부","100세이상","2016 년","393","49","344","14.2","390","47","343","13.7",
"읍부","100세이상","2017 년","444","50","394","12.7","444","50","394","12.7",
"읍부","100세이상","2018 년","504","66","438","15.1","504","66","438","15.1",
"읍부","100세이상","2019 년","564","89","475","18.7","563","89","474","18.8",
"읍부","100세이상","2020 년","667","106","561","18.9","665","104","561","18.5",
"읍부","100세이상","2021 년","814","124","690","18","812","122","690","17.7",
"읍부","100세이상","2022 년","867","128","739","17.3","865","126","739","17.1",
"읍부","100세이상","2023 년","986","144","842","17.1","982","142","840","16.9",
"읍부","15세미만","2015 년","705844","364930","340914","107","702707","363339","339368","107.1",
"읍부","15세미만","2016 년","701616","362260","339356","106.7","697725","360280","337445","106.8",
"읍부","15세미만","2017 년","698185","360011","338174","106.5","694046","357912","336134","106.5",
"읍부","15세미만","2018 년","705166","362893","342273","106","699495","360032","339463","106.1",
"읍부","15세미만","2019 년","693525","356848","336677","106","685684","352889","332795","106",
"읍부","15세미만","2020 년","682249","350916","331333","105.9","674424","346981","327443","106",
"읍부","15세미만","2021 년","677968","348483","329485","105.8","668700","343820","324880","105.8",
"읍부","15세미만","2022 년","638099","327987","310112","105.8","628064","322928","305136","105.8",
"읍부","15세미만","2023 년","606783","311897","294886","105.8","597017","306949","290068","105.8",
"읍부","15~64세","2015 년","3248131","1724099","1524032","113.1","3105454","1629374","1476080","110.4",
"읍부","15~64세","2016 년","3321910","1766507","1555403","113.6","3169617","1665191","1504426","110.7",
"읍부","15~64세","2017 년","3375041","1796716","1578325","113.8","3214754","1691686","1523068","111.1",
"읍부","15~64세","2018 년","3513260","1874222","1639038","114.3","3326816","1752543","1574273","111.3",
"읍부","15~64세","2019 년","3558439","1902420","1656019","114.9","3353078","1768479","1584599","111.6",
"읍부","15~64세","2020 년","3571914","1908250","1663664","114.7","3377344","1784735","1592609","112.1",
"읍부","15~64세","2021 년","3597300","1920064","1677236","114.5","3406954","1800870","1606084","112.1",
"읍부","15~64세","2022 년","3520364","1886115","1634249","115.4","3318597","1757275","1561322","112.6",
"읍부","15~64세","2023 년","3536656","1904236","1632420","116.7","3300602","1749422","1551180","112.8",
"읍부","65세이상","2015 년","662827","271679","391148","69.5","659536","270140","389396","69.4",
"읍부","65세이상","2016 년","684329","282197","402132","70.2","680709","280506","400203","70.1",
"읍부","65세이상","2017 년","721151","299831","421320","71.2","717194","298015","419179","71.1",
"읍부","65세이상","2018 년","765597","320692","444905","72.1","761224","318740","442484","72",
"읍부","65세이상","2019 년","805543","340148","465395","73.1","800254","337719","462535","73",
"읍부","65세이상","2020 년","858889","365185","493704","74","852879","362555","490324","73.9",
"읍부","65세이상","2021 년","908566","389927","518639","75.2","901886","386982","514904","75.2",
"읍부","65세이상","2022 년","940429","407307","533122","76.4","932545","403837","528708","76.4",
"읍부","65세이상","2023 년","987979","431863","556116","77.7","978869","427897","550972","77.7",
"읍부","85세이상","2015 년","57860","14346","43514","33","57711","14282","43429","32.9",
"읍부","85세이상","2016 년","62162","15455","46707","33.1","62000","15389","46611","33",
"읍부","85세이상","2017 년","69343","17197","52146","33","69207","17150","52057","32.9",
"읍부","85세이상","2018 년","76736","19310","57426","33.6","76615","19274","57341","33.6",
"읍부","85세이상","2019 년","84917","21899","63018","34.8","84728","21829","62899","34.7",
"읍부","85세이상","2020 년","94687","24831","69856","35.5","94515","24785","69730","35.5",
"읍부","85세이상","2021 년","104336","27898","76438","36.5","104136","27841","76295","36.5",
"읍부","85세이상","2022 년","109103","29550","79553","37.1","108870","29478","79392","37.1",
"읍부","85세이상","2023 년","116688","32004","84684","37.8","116370","31911","84459","37.8",
"읍부","평균연령","2015 년","40.4","39","41.9","","40.5","39.1","42","",
"읍부","평균연령","2016 년","40.8","39.4","42.3","","40.9","39.6","42.4","",
"읍부","평균연령","2017 년","41.3","39.9","42.8","","41.5","40.1","42.9","",
"읍부","평균연령","2018 년","41.8","40.4","43.2","","42","40.6","43.4","",
"읍부","평균연령","2019 년","42.3","40.9","43.8","","42.6","41.3","44","",
"읍부","평균연령","2020 년","43","41.6","44.5","","43.3","41.9","44.7","",
"읍부","평균연령","2021 년","43.6","42.2","45","","43.8","42.4","45.2","",
"읍부","평균연령","2022 년","44.2","42.8","45.7","","44.5","43.1","46","",
"읍부","평균연령","2023 년","44.8","43.4","46.4","","45.2","43.8","46.6","",
"읍부","중위연령","2015 년","41.1","39.8","42.4","","41.4","40.3","42.6","",
"읍부","중위연령","2016 년","41.5","40.1","42.9","","42","40.8","43.1","",
"읍부","중위연령","2017 년","42.1","40.7","43.6","","42.6","41.4","43.8","",
"읍부","중위연령","2018 년","42.6","41.2","44.2","","43.2","42","44.5","",
"읍부","중위연령","2019 년","43.3","41.8","45","","44","42.8","45.4","",
"읍부","중위연령","2020 년","44.2","42.7","45.8","","44.8","43.5","46.2","",
"읍부","중위연령","2021 년","44.8","43.3","46.5","","45.5","44.1","46.9","",
"읍부","중위연령","2022 년","45.6","44.1","47.4","","46.4","45","47.9","",
"읍부","중위연령","2023 년","46.3","44.6","48.2","","47.2","45.8","48.7","",
"면부","합계","2015 년","4774878","2455898","2318980","105.9","4546520","2291860","2254660","101.6",
"면부","합계","2016 년","4793569","2472341","2321228","106.5","4556905","2301931","2254974","102.1",
"면부","합계","2017 년","4835090","2498157","2336933","106.9","4592308","2324414","2267894","102.5",
"면부","합계","2018 년","4730290","2453691","2276599","107.8","4464067","2263139","2200928","102.8",
"면부","합계","2019 년","4698591","2447379","2251212","108.7","4415652","2244382","2171270","103.4",
"면부","합계","2020 년","4650781","2420392","2230389","108.5","4394145","2237761","2156384","103.8",
"면부","합계","2021 년","4534456","2352247","2182209","107.8","4292808","2182704","2110104","103.4",
"면부","합계","2022 년","4506486","2348865","2157621","108.9","4244198","2162250","2081948","103.9",
"면부","합계","2023 년","4536053","2383357","2152696","110.7","4220051","2155239","2064812","104.4",
"면부","0~4세","2015 년","142002","73287","68715","106.7","141023","72778","68245","106.6",
"면부","0~4세","2016 년","140514","72107","68407","105.4","139422","71531","67891","105.4",
"면부","0~4세","2017 년","138155","70974","67181","105.6","137001","70378","66623","105.6",
"면부","0~4세","2018 년","124135","63480","60655","104.7","122622","62697","59925","104.6",
"면부","0~4세","2019 년","115629","59143","56486","104.7","113714","58227","55487","104.9",
"면부","0~4세","2020 년","105638","53889","51749","104.1","103818","52996","50822","104.3",
"면부","0~4세","2021 년","93238","47524","45714","104","91319","46605","44714","104.2",
"면부","0~4세","2022 년","83318","42446","40872","103.9","81293","41456","39837","104.1",
"면부","0~4세","2023 년","77973","39756","38217","104","75906","38699","37207","104",
"면부","5~9세","2015 년","138835","72031","66804","107.8","138117","71660","66457","107.8",
"면부","5~9세","2016 년","142214","73799","68415","107.9","141316","73352","67964","107.9",
"면부","5~9세","2017 년","145411","75375","70036","107.6","144630","75004","69626","107.7",
"면부","5~9세","2018 년","137389","71377","66012","108.1","136347","70872","65475","108.2",
"면부","5~9세","2019 년","134987","69865","65122","107.3","133633","69181","64452","107.3",
"면부","5~9세","2020 년","132633","68450","64183","106.6","131362","67826","63536","106.8",
"면부","5~9세","2021 년","125054","64400","60654","106.2","123309","63544","59765","106.3",
"면부","5~9세","2022 년","115517","59547","55970","106.4","113500","58571","54929","106.6",
"면부","5~9세","2023 년","108184","55848","52336","106.7","106383","54967","51416","106.9",
"면부","10~14세","2015 년","148109","78243","69866","112","147654","78025","69629","112.1",
"면부","10~14세","2016 년","138329","72841","65488","111.2","137831","72606","65225","111.3",
"면부","10~14세","2017 년","137862","72423","65439","110.7","137364","72185","65179","110.7",
"면부","10~14세","2018 년","132439","69249","63190","109.6","131712","68872","62840","109.6",
"면부","10~14세","2019 년","129885","67786","62099","109.2","128973","67309","61664","109.2",
"면부","10~14세","2020 년","133459","69659","63800","109.2","132562","69193","63369","109.2",
"면부","10~14세","2021 년","131219","68466","62753","109.1","130115","67902","62213","109.1",
"면부","10~14세","2022 년","128894","67355","61539","109.5","127491","66674","60817","109.6",
"면부","10~14세","2023 년","127080","66538","60542","109.9","125564","65772","59792","110",
"면부","15~19세","2015 년","219047","118195","100852","117.2","217062","117195","99867","117.4",
"면부","15~19세","2016 년","211365","113594","97771","116.2","209222","112501","96721","116.3",
"면부","15~19세","2017 년","201955","108645","93310","116.4","199365","107270","92095","116.5",
"면부","15~19세","2018 년","183252","99480","83772","118.8","180118","97669","82449","118.5",
"면부","15~19세","2019 년","168858","91587","77271","118.5","165861","89886","75975","118.3",
"면부","15~19세","2020 년","154571","84010","70561","119.1","152583","82935","69648","119.1",
"면부","15~19세","2021 년","138641","74497","64144","116.1","136821","73543","63278","116.2",
"면부","15~19세","2022 년","142454","76243","66211","115.2","139561","74548","65013","114.7",
"면부","15~19세","2023 년","141310","75757","65553","115.6","136912","72942","63970","114",
"면부","20~24세","2015 년","267090","158334","108756","145.6","235327","136018","99309","137",
"면부","20~24세","2016 년","270249","160572","109677","146.4","237562","137530","100032","137.5",
"면부","20~24세","2017 년","264404","157696","106708","147.8","232394","135198","97196","139.1",
"면부","20~24세","2018 년","253624","152495","101129","150.8","217312","126562","90750","139.5",
"면부","20~24세","2019 년","239995","144846","95149","152.2","202989","118190","84799","139.4",
"면부","20~24세","2020 년","219062","132275","86787","152.4","190661","112240","78421","143.1",
"면부","20~24세","2021 년","194940","117263","77677","151","173868","103006","70862","145.4",
"면부","20~24세","2022 년","186388","112489","73899","152.2","163283","96372","66911","144",
"면부","20~24세","2023 년","178797","110322","68475","161.1","148136","87855","60281","145.7",
"면부","25~29세","2015 년","255581","159011","96570","164.7","200842","117804","83038","141.9",
"면부","25~29세","2016 년","257530","160402","97128","165.1","201025","117273","83752","140",
"면부","25~29세","2017 년","262289","163808","98481","166.3","204607","119829","84778","141.3",
"면부","25~29세","2018 년","258754","163233","95521","170.9","196413","115590","80823","143",
"면부","25~29세","2019 년","257797","164343","93454","175.9","193197","114860","78337","146.6",
"면부","25~29세","2020 년","244649","156812","87837","178.5","187341","112928","74413","151.8",
"면부","25~29세","2021 년","228286","146419","81867","178.8","177340","107715","69625","154.7",
"면부","25~29세","2022 년","224184","145426","78758","184.6","169002","102872","66130","155.6",
"면부","25~29세","2023 년","227887","149703","78184","191.5","162034","98477","63557","154.9",
"면부","30~34세","2015 년","263949","160422","103527","155","218234","124549","93685","132.9",
"면부","30~34세","2016 년","258993","157297","101696","154.7","210868","119732","91136","131.4",
"면부","30~34세","2017 년","253858","154195","99663","154.7","203938","115423","88515","130.4",
"면부","30~34세","2018 년","242069","148772","93297","159.5","186663","106268","80395","132.2",
"면부","30~34세","2019 년","238668","148034","90634","163.3","180350","103241","77109","133.9",
"면부","30~34세","2020 년","228306","140659","87647","160.5","172950","98322","74628","131.7",
"면부","30~34세","2021 년","217383","133917","83466","160.4","165441","94574","70867","133.5",
"면부","30~34세","2022 년","218352","137081","81271","168.7","161720","93301","68419","136.4",
"면부","30~34세","2023 년","232227","148436","83791","177.2","163160","94399","68761","137.3",
"면부","35~39세","2015 년","256039","152447","103592","147.2","226161","129163","96998","133.2",
"면부","35~39세","2016 년","262426","155495","106931","145.4","231323","131220","100103","131.1",
"면부","35~39세","2017 년","274227","161670","112557","143.6","240742","135994","104748","129.8",
"면부","35~39세","2018 년","268769","158441","110328","143.6","230755","129700","101055","128.3",
"면부","35~39세","2019 년","263463","155631","107832","144.3","222426","124844","97582","127.9",
"면부","35~39세","2020 년","247610","145851","101759","143.3","208120","116154","91966","126.3",
"면부","35~39세","2021 년","228725","134621","94104","143.1","189576","105388","84188","125.2",
"면부","35~39세","2022 년","216135","128710","87425","147.2","173753","96675","77078","125.4",
"면부","35~39세","2023 년","217473","131160","86313","152","165876","92209","73667","125.2",
"면부","40~44세","2015 년","285740","169151","116589","145.1","265522","154476","111046","139.1",
"면부","40~44세","2016 년","274750","162433","112317","144.6","254598","147915","106683","138.6",
"면부","40~44세","2017 년","269971","158656","111315","142.5","250115","144491","105624","136.8",
"면부","40~44세","2018 년","254145","150196","103949","144.5","231832","134347","97485","137.8",
"면부","40~44세","2019 년","248402","146853","101549","144.6","223555","129179","94376","136.9",
"면부","40~44세","2020 년","248225","145850","102375","142.5","224095","128586","95509","134.6",
"면부","40~44세","2021 년","243646","141789","101857","139.2","218999","124312","94687","131.3",
"면부","40~44세","2022 년","244429","142187","102242","139.1","217330","122904","94426","130.2",
"면부","40~44세","2023 년","249923","145580","104343","139.5","217354","122383","94971","128.9",
"면부","45~49세","2015 년","327687","183532","144155","127.3","312643","174027","138616","125.5",
"면부","45~49세","2016 년","328287","184652","143635","128.6","312795","174769","138026","126.6",
"면부","45~49세","2017 년","325595","184887","140708","131.4","309670","174828","134842","129.7",
"면부","45~49세","2018 년","309728","177533","132195","134.3","293247","167042","126205","132.4",
"면부","45~49세","2019 년","300875","174286","126589","137.7","283042","162636","120406","135.1",
"면부","45~49세","2020 년","289929","168185","121744","138.1","274185","158031","116154","136.1",
"면부","45~49세","2021 년","269700","155898","113802","137","253785","145511","108274","134.4",
"면부","45~49세","2022 년","258828","149292","109536","136.3","242663","138727","103936","133.5",
"면부","45~49세","2023 년","250691","145083","105608","137.4","231768","132763","99005","134.1",
"면부","50~54세","2015 년","393109","209637","183472","114.3","381591","203039","178552","113.7",
"면부","50~54세","2016 년","375132","202786","172346","117.7","362915","195752","167163","117.1",
"면부","50~54세","2017 년","366921","198137","168784","117.4","354556","191081","163475","116.9",
"면부","50~54세","2018 년","358356","193939","164417","118","346325","187057","159268","117.4",
"면부","50~54세","2019 년","360106","196980","163126","120.8","346766","189014","157752","119.8",
"면부","50~54세","2020 년","354747","195019","159728","122.1","342928","188248","154680","121.7",
"면부","50~54세","2021 년","346591","189999","156592","121.3","334508","183021","151487","120.8",
"면부","50~54세","2022 년","337847","187176","150671","124.2","324923","179623","145300","123.6",
"면부","50~54세","2023 년","328867","183970","144897","127","314372","175335","139037","126.1",
"면부","55~59세","2015 년","438274","224667","213607","105.2","430510","220203","210307","104.7",
"면부","55~59세","2016 년","458430","235833","222597","105.9","450811","231551","219260","105.6",
"면부","55~59세","2017 년","467423","241012","226411","106.4","459447","236612","222835","106.2",
"면부","55~59세","2018 년","457254","236770","220484","107.4","448928","232248","216680","107.2",
"면부","55~59세","2019 년","443633","231525","212108","109.2","434301","226313","207988","108.8",
"면부","55~59세","2020 년","429707","227074","202633","112.1","420894","222402","198492","112",
"면부","55~59세","2021 년","403031","214676","188355","114","393719","209715","184004","114",
"면부","55~59세","2022 년","392889","209083","183806","113.8","383483","204024","179459","113.7",
"면부","55~59세","2023 년","393507","209635","183872","114","383283","204063","179220","113.9",
"면부","60~64세","2015 년","365208","181708","183500","99","360953","179334","181619","98.7",
"면부","60~64세","2016 년","393657","197898","195759","101.1","388994","195277","193717","100.8",
"면부","60~64세","2017 년","412375","209263","203112","103","407361","206428","200933","102.7",
"면부","60~64세","2018 년","431863","221072","210791","104.9","426866","218310","208556","104.7",
"면부","60~64세","2019 년","450600","231809","218791","105.9","445281","228839","216442","105.7",
"면부","60~64세","2020 년","473382","244136","229246","106.5","468090","241355","226735","106.4",
"면부","60~64세","2021 년","493071","254316","238755","106.5","487758","251559","236199","106.5",
"면부","60~64세","2022 년","499228","258829","240399","107.7","493490","255924","237566","107.7",
"면부","60~64세","2023 년","501404","261553","239851","109","494698","258120","236578","109.1",
"면부","65~69세","2015 년","318393","155697","162696","95.7","316519","154681","161838","95.6",
"면부","65~69세","2016 년","326376","160406","165970","96.6","324395","159348","165047","96.5",
"면부","65~69세","2017 년","338600","167272","171328","97.6","336533","166169","170364","97.5",
"면부","65~69세","2018 년","336709","166737","169972","98.1","334619","165621","168998","98",
"면부","65~69세","2019 년","347260","172720","174540","99","344954","171513","173441","98.9",
"면부","65~69세","2020 년","374886","187606","187280","100.2","372437","186387","186050","100.2",
"면부","65~69세","2021 년","400174","202402","197772","102.3","397471","201068","196403","102.4",
"면부","65~69세","2022 년","417177","213384","203793","104.7","414158","211892","202266","104.8",
"면부","65~69세","2023 년","444941","229463","215478","106.5","441529","227799","213730","106.6",
"면부","70~74세","2015 년","323231","139612","183619","76","322552","139299","183253","76",
"면부","70~74세","2016 년","303261","133571","169690","78.7","302539","133225","169314","78.7",
"면부","70~74세","2017 년","288962","131003","157959","82.9","288215","130645","157570","82.9",
"면부","70~74세","2018 년","287125","134110","153015","87.6","286347","133744","152603","87.6",
"면부","70~74세","2019 년","294149","141198","152951","92.3","293206","140729","152477","92.3",
"면부","70~74세","2020 년","305305","148144","157161","94.3","304282","147661","156621","94.3",
"면부","70~74세","2021 년","310931","151270","159661","94.7","309833","150754","159079","94.8",
"면부","70~74세","2022 년","321725","157720","164005","96.2","320423","157139","163284","96.2",
"면부","70~74세","2023 년","325972","160594","165378","97.1","324494","159940","164554","97.2",
"면부","75~79세","2015 년","303596","119662","183934","65.1","303147","119477","183670","65",
"면부","75~79세","2016 년","305123","121185","183938","65.9","304682","121009","183673","65.9",
"면부","75~79세","2017 년","319697","128011","191686","66.8","319287","127857","191430","66.8",
"면부","75~79세","2018 년","311682","125874","185808","67.7","311289","125715","185574","67.7",
"면부","75~79세","2019 년","298127","121330","176797","68.6","297695","121149","176546","68.6",
"면부","75~79세","2020 년","287007","117996","169011","69.8","286568","117841","168727","69.8",
"면부","75~79세","2021 년","269041","113196","155845","72.6","268593","113024","155569","72.7",
"면부","75~79세","2022 년","255924","111695","144229","77.4","255388","111482","143906","77.5",
"면부","75~79세","2023 년","258426","116865","141561","82.6","257734","116590","141144","82.6",
"면부","80~84세","2015 년","200821","67286","133535","50.4","200636","67210","133426","50.4",
"면부","80~84세","2016 년","212703","73033","139670","52.3","212522","72962","139560","52.3",
"면부","80~84세","2017 년","222552","77454","145098","53.4","222373","77387","144986","53.4",
"면부","80~84세","2018 년","228780","80446","148334","54.2","228575","80380","148195","54.2",
"면부","80~84세","2019 년","237637","84464","153173","55.1","237377","84368","153009","55.1",
"면부","80~84세","2020 년","238899","85695","153204","55.9","238634","85614","153020","55.9",
"면부","80~84세","2021 년","242236","87457","154779","56.5","241948","87369","154579","56.5",
"면부","80~84세","2022 년","254520","92883","161637","57.5","254208","92790","161418","57.5",
"면부","80~84세","2023 년","251853","92844","159009","58.4","251510","92733","158777","58.4",
"면부","85~89세","2015 년","91039","24602","66437","37","90951","24569","66382","37",
"면부","85~89세","2016 년","95948","25910","70038","37","95859","25876","69983","37",
"면부","85~89세","2017 년","103719","28502","75217","37.9","103629","28472","75157","37.9",
"면부","85~89세","2018 년","110098","30756","79342","38.8","110003","30721","79282","38.7",
"면부","85~89세","2019 년","120051","34242","85809","39.9","119928","34192","85736","39.9",
"면부","85~89세","2020 년","129751","37664","92087","40.9","129661","37633","92028","40.9",
"면부","85~89세","2021 년","140777","41704","99073","42.1","140680","41671","99009","42.1",
"면부","85~89세","2022 년","146854","44002","102852","42.8","146748","43969","102779","42.8",
"면부","85~89세","2023 년","152747","45919","106828","43","152605","45877","106728","43",
"면부","90~94세","2015 년","30355","7142","23213","30.8","30327","7134","23193","30.8",
"면부","90~94세","2016 년","30890","7211","23679","30.5","30854","7199","23655","30.4",
"면부","90~94세","2017 년","32804","7666","25138","30.5","32782","7660","25122","30.5",
"면부","90~94세","2018 년","34848","8023","26825","29.9","34827","8018","26809","29.9",
"면부","90~94세","2019 년","38899","8889","30010","29.6","38859","8875","29984","29.6",
"면부","90~94세","2020 년","42745","9452","33293","28.4","42712","9447","33265","28.4",
"면부","90~94세","2021 년","46720","10362","36358","28.5","46685","10355","36330","28.5",
"면부","90~94세","2022 년","50272","11234","39038","28.8","50240","11225","39015","28.8",
"면부","90~94세","2023 년","54138","12195","41943","29.1","54095","12183","41912","29.1",
"면부","95~99세","2015 년","5990","1122","4868","23","5971","1111","4860","22.9",
"면부","95~99세","2016 년","6581","1209","5372","22.5","6566","1199","5367","22.3",
"면부","95~99세","2017 년","7455","1386","6069","22.8","7446","1383","6063","22.8",
"면부","95~99세","2018 년","8342","1585","6757","23.5","8338","1583","6755","23.4",
"면부","95~99세","2019 년","8509","1685","6824","24.7","8489","1677","6812","24.6",
"면부","95~99세","2020 년","9037","1793","7244","24.8","9032","1791","7241","24.7",
"면부","95~99세","2021 년","9621","1857","7764","23.9","9612","1856","7756","23.9",
"면부","95~99세","2022 년","10059","1879","8180","23","10051","1879","8172","23",
"면부","95~99세","2023 년","11030","1888","9142","20.7","11018","1887","9131","20.7",
"면부","100세이상","2015 년","783","110","673","16.3","778","108","670","16.1",
"면부","100세이상","2016 년","811","107","704","15.2","806","104","702","14.8",
"면부","100세이상","2017 년","855","122","733","16.6","853","120","733","16.4",
"면부","100세이상","2018 년","929","123","806","15.3","929","123","806","15.3",
"면부","100세이상","2019 년","1061","163","898","18.2","1056","160","896","17.9",
"면부","100세이상","2020 년","1233","173","1060","16.3","1230","171","1059","16.1",
"면부","100세이상","2021 년","1431","214","1217","17.6","1428","212","1216","17.4",
"면부","100세이상","2022 년","1492","204","1288","15.8","1490","203","1287","15.8",
"면부","100세이상","2023 년","1623","248","1375","18","1620","246","1374","17.9",
"면부","15세미만","2015 년","428946","223561","205385","108.8","426794","222463","204331","108.9",
"면부","15세미만","2016 년","421057","218747","202310","108.1","418569","217489","201080","108.2",
"면부","15세미만","2017 년","421428","218772","202656","108","418995","217567","201428","108",
"면부","15세미만","2018 년","393963","204106","189857","107.5","390681","202441","188240","107.5",
"면부","15세미만","2019 년","380501","196794","183707","107.1","376320","194717","181603","107.2",
"면부","15세미만","2020 년","371730","191998","179732","106.8","367742","190015","177727","106.9",
"면부","15세미만","2021 년","349511","180390","169121","106.7","344743","178051","166692","106.8",
"면부","15세미만","2022 년","327729","169348","158381","106.9","322284","166701","155583","107.1",
"면부","15세미만","2023 년","313237","162142","151095","107.3","307853","159438","148415","107.4",
"면부","15~64세","2015 년","3071724","1717104","1354620","126.8","2848845","1555808","1293037","120.3",
"면부","15~64세","2016 년","3090819","1730962","1359857","127.3","2860113","1563520","1296593","120.6",
"면부","15~64세","2017 년","3099018","1737969","1361049","127.7","2862195","1567154","1295041","121",
"면부","15~64세","2018 년","3017814","1701931","1315883","129.3","2758459","1514793","1243666","121.8",
"면부","15~64세","2019 년","2972397","1685894","1286503","131","2697768","1487002","1210766","122.8",
"면부","15~64세","2020 년","2890188","1639871","1250317","131.2","2641847","1461201","1180646","123.8",
"면부","15~64세","2021 년","2764014","1563395","1200619","130.2","2531815","1398344","1133471","123.4",
"면부","15~64세","2022 년","2720734","1546516","1174218","131.7","2469208","1364970","1104238","123.6",
"면부","15~64세","2023 년","2722086","1561199","1160887","134.5","2417593","1338546","1079047","124",
"면부","65세이상","2015 년","1274208","515233","758975","67.9","1270881","513589","757292","67.8",
"면부","65세이상","2016 년","1281693","522632","759061","68.9","1278223","520922","757301","68.8",
"면부","65세이상","2017 년","1314644","541416","773228","70","1311118","539693","771425","70",
"면부","65세이상","2018 년","1318513","547654","770859","71","1314927","545905","769022","71",
"면부","65세이상","2019 년","1345693","564691","781002","72.3","1341564","562663","778901","72.2",
"면부","65세이상","2020 년","1388863","588523","800340","73.5","1384556","586545","798011","73.5",
"면부","65세이상","2021 년","1420931","608462","812469","74.9","1416250","606309","809941","74.9",
"면부","65세이상","2022 년","1458023","633001","825022","76.7","1452706","630579","822127","76.7",
"면부","65세이상","2023 년","1500730","660016","840714","78.5","1494605","657255","837350","78.5",
"면부","85세이상","2015 년","128167","32976","95191","34.6","128027","32922","95105","34.6",
"면부","85세이상","2016 년","134230","34437","99793","34.5","134085","34378","99707","34.5",
"면부","85세이상","2017 년","144833","37676","107157","35.2","144710","37635","107075","35.1",
"면부","85세이상","2018 년","154217","40487","113730","35.6","154097","40445","113652","35.6",
"면부","85세이상","2019 년","168520","44979","123541","36.4","168332","44904","123428","36.4",
"면부","85세이상","2020 년","182766","49082","133684","36.7","182635","49042","133593","36.7",
"면부","85세이상","2021 년","198549","54137","144412","37.5","198405","54094","144311","37.5",
"면부","85세이상","2022 년","208677","57319","151358","37.9","208529","57276","151253","37.9",
"면부","85세이상","2023 년","219538","60250","159288","37.8","219338","60193","159145","37.8",
"면부","평균연령","2015 년","48.4","45.7","51.3","","49.1","46.5","51.7","",
"면부","평균연령","2016 년","48.7","46","51.5","","49.4","46.9","51.9","",
"면부","평균연령","2017 년","49","46.4","51.8","","49.8","47.3","52.3","",
"면부","평균연령","2018 년","49.7","47","52.5","","50.5","48.1","53","",
"면부","평균연령","2019 년","50.2","47.6","53.1","","51.2","48.8","53.7","",
"면부","평균연령","2020 년","50.9","48.4","53.7","","51.8","49.5","54.3","",
"면부","평균연령","2021 년","51.8","49.3","54.6","","52.7","50.4","55.2","",
"면부","평균연령","2022 년","52.3","49.8","55.1","","53.3","51","55.7","",
"면부","평균연령","2023 년","52.7","50.1","55.5","","53.9","51.7","56.3","",
"면부","중위연령","2015 년","51.2","47.4","54.9","","52.5","49.2","55.5","",
"면부","중위연령","2016 년","51.6","47.9","55.4","","52.9","49.8","55.9","",
"면부","중위연령","2017 년","52.1","48.5","55.8","","53.4","50.3","56.4","",
"면부","중위연령","2018 년","52.9","49.3","56.7","","54.4","51.4","57.4","",
"면부","중위연령","2019 년","53.6","50","57.4","","55.2","52.3","58.2","",
"면부","중위연령","2020 년","54.5","51.2","58.2","","56","53.2","58.9","",
"면부","중위연령","2021 년","55.7","52.5","59.1","","57","54.4","59.8","",
"면부","중위연령","2022 년","56.3","53.2","59.7","","57.8","55.2","60.4","",
"면부","중위연령","2023 년","56.7","53.5","60.1","","58.5","56","61","",
"동부","합계","2015 년","41677695","20791896","20885799","99.6","40691446","20265126","20426320","99.2",
"동부","합계","2016 년","41768130","20813682","20954448","99.3","40750840","20273612","20477228","99",
"동부","합계","2017 년","41793040","20813340","20979700","99.2","40724958","20250365","20474593","98.9",
"동부","합계","2018 년","41915199","20865697","21049502","99.1","40726349","20237100","20489249","98.8",
"동부","합계","2019 년","42023105","20905275","21117830","99","40745617","20231193","20514424","98.6",
"동부","합계","2020 년","42065303","20870464","21194839","98.5","40834701","20240556","20594145","98.3",
"동부","합계","2021 년","42019781","20839323","21180458","98.4","40817756","20229161","20588595","98.3",
"동부","합계","2022 년","42086894","20865024","21221870","98.3","40816522","20220224","20596298","98.2",
"동부","합계","2023 년","42107050","20872499","21234551","98.3","40742832","20171216","20571616","98.1",
"동부","0~4세","2015 년","1883104","965992","917112","105.3","1862386","955444","906942","105.3",
"동부","0~4세","2016 년","1846784","946594","900190","105.2","1824011","934995","889016","105.2",
"동부","0~4세","2017 년","1743153","893171","849982","105.1","1719420","881153","838267","105.1",
"동부","0~4세","2018 년","1659733","851279","808454","105.3","1631706","837010","794696","105.3",
"동부","0~4세","2019 년","1562756","801873","760883","105.4","1528574","784330","744244","105.4",
"동부","0~4세","2020 년","1430046","733829","696217","105.4","1398315","717601","680714","105.4",
"동부","0~4세","2021 년","1303672","669385","634287","105.5","1275143","654755","620388","105.5",
"동부","0~4세","2022 년","1221282","626396","594886","105.3","1193794","612281","581513","105.3",
"동부","0~4세","2023 년","1142560","585447","557113","105.1","1117935","572849","545086","105.1",
"동부","5~9세","2015 년","1893768","976334","917434","106.4","1880563","969485","911078","106.4",
"동부","5~9세","2016 년","1920402","988516","931886","106.1","1904995","980435","924560","106",
"동부","5~9세","2017 년","1911886","983359","928527","105.9","1898749","976545","922204","105.9",
"동부","5~9세","2018 년","1892246","972189","920057","105.7","1876251","964048","912203","105.7",
"동부","5~9세","2019 년","1891119","970438","920681","105.4","1869555","959498","910057","105.4",
"동부","5~9세","2020 년","1882307","964537","917770","105.1","1860468","953443","907025","105.1",
"동부","5~9세","2021 년","1839366","941779","897587","104.9","1812569","928285","884284","105",
"동부","5~9세","2022 년","1751258","896516","854742","104.9","1722039","881811","840228","104.9",
"동부","5~9세","2023 년","1657837","849219","808618","105","1632758","836514","796244","105.1",
"동부","10~14세","2015 년","2042651","1060734","981917","108","2034257","1056384","977873","108",
"동부","10~14세","2016 년","1932354","1001984","930370","107.7","1923038","997167","925871","107.7",
"동부","10~14세","2017 년","1908100","986645","921455","107.1","1900552","982779","917773","107.1",
"동부","10~14세","2018 년","1891700","976080","915620","106.6","1881748","971062","910686","106.6",
"동부","10~14세","2019 년","1864279","960671","903608","106.3","1851818","954372","897446","106.3",
"동부","10~14세","2020 년","1887825","972100","915725","106.2","1874997","965582","909415","106.2",
"동부","10~14세","2021 년","1916954","985560","931394","105.8","1902093","977919","924174","105.8",
"동부","10~14세","2022 년","1921560","987167","934393","105.6","1904049","978267","925782","105.7",
"동부","10~14세","2023 년","1899009","974721","924288","105.5","1880638","965427","915211","105.5",
"동부","15~19세","2015 년","2679885","1395027","1284858","108.6","2660030","1385967","1274063","108.8",
"동부","15~19세","2016 년","2580236","1339997","1240239","108","2557202","1329614","1227588","108.3",
"동부","15~19세","2017 년","2438175","1266690","1171485","108.1","2412709","1255167","1157542","108.4",
"동부","15~19세","2018 년","2308946","1198443","1110503","107.9","2278080","1183941","1094139","108.2",
"동부","15~19세","2019 년","2196743","1137687","1059056","107.4","2162270","1121967","1040303","107.9",
"동부","15~19세","2020 년","2040577","1054286","986291","106.9","2017552","1044087","973465","107.3",
"동부","15~19세","2021 년","1929145","996122","933023","106.8","1908436","987083","921353","107.1",
"동부","15~19세","2022 년","1920759","988810","931949","106.1","1890625","975103","915522","106.5",
"동부","15~19세","2023 년","1914893","983786","931107","105.7","1877834","966382","911452","106",
"동부","20~24세","2015 년","2980057","1568333","1411724","111.1","2884446","1523499","1360947","111.9",
"동부","20~24세","2016 년","2987736","1570063","1417673","110.7","2886718","1523501","1363217","111.8",
"동부","20~24세","2017 년","2956989","1547064","1409925","109.7","2845941","1495829","1350112","110.8",
"동부","20~24세","2018 년","2924080","1524154","1399926","108.9","2788733","1458322","1330411","109.6",
"동부","20~24세","2019 년","2869295","1488312","1380983","107.8","2720829","1415739","1305090","108.5",
"동부","20~24세","2020 년","2842155","1458988","1383167","105.5","2719123","1400211","1318912","106.2",
"동부","20~24세","2021 년","2735930","1399968","1335962","104.8","2616337","1345899","1270438","105.9",
"동부","20~24세","2022 년","2594763","1329686","1265077","105.1","2460549","1269973","1190576","106.7",
"동부","20~24세","2023 년","2473833","1268293","1205540","105.2","2327269","1200435","1126834","106.5",
"동부","25~29세","2015 년","2757203","1428161","1329042","107.5","2604997","1343808","1261189","106.6",
"동부","25~29세","2016 년","2788269","1447288","1340981","107.9","2637849","1364531","1273318","107.2",
"동부","25~29세","2017 년","2872322","1496566","1375756","108.8","2719297","1413330","1305967","108.2",
"동부","25~29세","2018 년","2968436","1552888","1415548","109.7","2807791","1465025","1342766","109.1",
"동부","25~29세","2019 년","3051507","1599026","1452481","110.1","2887361","1509709","1377652","109.6",
"동부","25~29세","2020 년","3114864","1625070","1489794","109.1","2965451","1548355","1417096","109.3",
"동부","25~29세","2021 년","3125142","1628689","1496453","108.8","2985960","1558581","1427379","109.2",
"동부","25~29세","2022 년","3096118","1608436","1487682","108.1","2948293","1533142","1415151","108.3",
"동부","25~29세","2023 년","3047220","1578000","1469220","107.4","2885175","1493514","1391661","107.3",
"동부","30~34세","2015 년","3221411","1651851","1569560","105.2","3093201","1575269","1517932","103.8",
"동부","30~34세","2016 년","3054028","1567125","1486903","105.4","2917508","1487302","1430206","104",
"동부","30~34세","2017 년","2889363","1486015","1403348","105.9","2738896","1399341","1339555","104.5",
"동부","30~34세","2018 년","2792890","1440744","1352146","106.6","2625789","1345671","1280118","105.1",
"동부","30~34세","2019 년","2764540","1430514","1334026","107.2","2588112","1331675","1256437","106",
"동부","30~34세","2020 년","2774709","1436583","1338126","107.4","2600694","1342897","1257797","106.8",
"동부","30~34세","2021 년","2812136","1457952","1354184","107.7","2650266","1372096","1278170","107.3",
"동부","30~34세","2022 년","2915396","1518859","1396537","108.8","2755296","1433075","1322221","108.4",
"동부","30~34세","2023 년","3010930","1577245","1433685","110","2842407","1484320","1358087","109.3",
"동부","35~39세","2015 년","3306159","1678522","1627637","103.1","3211239","1620069","1591170","101.8",
"동부","35~39세","2016 년","3363824","1709024","1654800","103.3","3264710","1648964","1615746","102.1",
"동부","35~39세","2017 년","3408899","1734226","1674673","103.6","3298268","1668280","1629988","102.3",
"동부","35~39세","2018 년","3435423","1749809","1685614","103.8","3308538","1675450","1633088","102.6",
"동부","35~39세","2019 년","3341789","1705491","1636298","104.2","3204378","1626224","1578154","103",
"동부","35~39세","2020 년","3183275","1625252","1558023","104.3","3042083","1546801","1495282","103.4",
"동부","35~39세","2021 년","3032070","1551062","1481008","104.7","2888202","1471989","1416213","103.9",
"동부","35~39세","2022 년","2889719","1482324","1407395","105.3","2738299","1399146","1339153","104.5",
"동부","35~39세","2023 년","2797008","1441414","1355594","106.3","2630027","1348643","1281384","105.2",
"동부","40~44세","2015 년","3656010","1837640","1818370","101.1","3567451","1785377","1782074","100.2",
"동부","40~44세","2016 년","3489978","1755565","1734413","101.2","3404022","1704629","1699393","100.3",
"동부","40~44세","2017 년","3380670","1697464","1683206","100.8","3294621","1647189","1647432","100",
"동부","40~44세","2018 년","3266163","1645565","1620598","101.5","3171651","1590891","1580760","100.6",
"동부","40~44세","2019 년","3216921","1621734","1595187","101.7","3113575","1562447","1551128","100.7",
"동부","40~44세","2020 년","3258545","1641828","1616717","101.6","3154242","1583567","1570675","100.8",
"동부","40~44세","2021 년","3323118","1678513","1644605","102.1","3218339","1620331","1598008","101.4",
"동부","40~44세","2022 년","3391035","1716961","1674074","102.6","3277118","1654007","1623111","101.9",
"동부","40~44세","2023 년","3418783","1733798","1684985","102.9","3292277","1663815","1628462","102.2",
"동부","45~49세","2015 년","3677944","1829471","1848473","99","3583942","1780036","1803906","98.7",
"동부","45~49세","2016 년","3766365","1867419","1898946","98.3","3671216","1816709","1854507","98",
"동부","45~49세","2017 년","3795128","1890821","1904307","99.3","3696137","1837791","1858346","98.9",
"동부","45~49세","2018 년","3762200","1877538","1884662","99.6","3657018","1820353","1836665","99.1",
"동부","45~49세","2019 년","3714729","1857446","1857283","100","3606879","1797969","1808910","99.4",
"동부","45~49세","2020 년","3603893","1798432","1805461","99.6","3504616","1745090","1759526","99.2",
"동부","45~49세","2021 년","3441409","1720558","1720851","100","3348671","1670303","1678368","99.5",
"동부","45~49세","2022 년","3350347","1672929","1677418","99.7","3259314","1623781","1635533","99.3",
"동부","45~49세","2023 년","3242551","1625140","1617411","100.5","3145124","1572737","1572387","100",
"동부","50~54세","2015 년","3506520","1751909","1754611","99.8","3410712","1705124","1705588","100",
"동부","50~54세","2016 년","3416761","1713608","1703153","100.6","3316634","1663951","1652683","100.7",
"동부","50~54세","2017 년","3390026","1690942","1699084","99.5","3291844","1641963","1649881","99.5",
"동부","50~54세","2018 년","3449081","1710377","1738704","98.4","3348200","1659276","1688924","98.2",
"동부","50~54세","2019 년","3552081","1757467","1794614","97.9","3448124","1703542","1744582","97.6",
"동부","50~54세","2020 년","3592715","1775983","1816732","97.8","3491541","1724839","1766702","97.6",
"동부","50~54세","2021 년","3688759","1821210","1867549","97.5","3588037","1769312","1818725","97.3",
"동부","50~54세","2022 년","3731364","1850964","1880400","98.4","3626547","1796188","1830359","98.1",
"동부","50~54세","2023 년","3707103","1841850","1865253","98.7","3597824","1784439","1813385","98.4",
"동부","55~59세","2015 년","3182242","1572740","1609502","97.7","3103252","1534506","1568746","97.8",
"동부","55~59세","2016 년","3346230","1649548","1696682","97.2","3271527","1613335","1658192","97.3",
"동부","55~59세","2017 년","3413334","1685820","1727514","97.6","3338057","1649570","1688487","97.7",
"동부","55~59세","2018 년","3465361","1713146","1752215","97.8","3375145","1669274","1705871","97.9",
"동부","55~59세","2019 년","3439657","1703767","1735890","98.1","3341277","1655189","1686088","98.2",
"동부","55~59세","2020 년","3376279","1671949","1704330","98.1","3276823","1623807","1653016","98.2",
"동부","55~59세","2021 년","3292468","1639668","1652800","99.2","3191325","1589958","1601367","99.3",
"동부","55~59세","2022 년","3285883","1627962","1657921","98.2","3185816","1578630","1607186","98.2",
"동부","55~59세","2023 년","3348431","1649929","1698502","97.1","3248898","1600358","1648540","97.1",
"동부","60~64세","2015 년","2210398","1077319","1133079","95.1","2156305","1050480","1105825","95",
"동부","60~64세","2016 년","2414617","1176250","1238367","95","2355224","1146842","1208382","94.9",
"동부","60~64세","2017 년","2549563","1243320","1306243","95.2","2483413","1210737","1272676","95.1",
"동부","60~64세","2018 년","2727901","1333489","1394412","95.6","2657735","1299177","1358558","95.6",
"동부","60~64세","2019 년","2891934","1410937","1480997","95.3","2819120","1375339","1443781","95.3",
"동부","60~64세","2020 년","3038622","1480406","1558216","95","2960723","1443174","1517549","95.1",
"동부","60~64세","2021 년","3202548","1558893","1643655","94.8","3130587","1524629","1605958","94.9",
"동부","60~64세","2022 년","3269374","1592286","1677088","94.9","3193934","1556499","1637435","95.1",
"동부","60~64세","2023 년","3326620","1623580","1703040","95.3","3241465","1582982","1658483","95.4",
"동부","65~69세","2015 년","1629723","778383","851340","91.4","1607232","767637","839595","91.4",
"동부","65~69세","2016 년","1678474","800839","877635","91.2","1653489","788911","864578","91.2",
"동부","65~69세","2017 년","1761650","842630","919020","91.7","1732904","828988","903916","91.7",
"동부","65~69세","2018 년","1808996","863372","945624","91.3","1776938","848219","928719","91.3",
"동부","65~69세","2019 년","1905217","910967","994250","91.6","1868526","893715","974811","91.7",
"동부","65~69세","2020 년","2092989","997896","1095093","91.1","2050440","978110","1072330","91.2",
"동부","65~69세","2021 년","2283372","1088406","1194966","91.1","2238976","1067675","1171301","91.2",
"동부","65~69세","2022 년","2420769","1155135","1265634","91.3","2370205","1131355","1238850","91.3",
"동부","65~69세","2023 년","2591239","1239069","1352170","91.6","2536896","1213766","1323130","91.7",
"동부","70~74세","2015 년","1273733","578485","695248","83.2","1265333","574877","690456","83.3",
"동부","70~74세","2016 년","1272885","581495","691390","84.1","1264403","577966","686437","84.2",
"동부","70~74세","2017 년","1296992","593754","703238","84.4","1287845","590014","697831","84.5",
"동부","70~74세","2018 년","1361722","626485","735237","85.2","1351430","622326","729104","85.4",
"동부","70~74세","2019 년","1441006","665954","775052","85.9","1427983","660425","767558","86",
"동부","70~74세","2020 년","1519357","702861","816496","86.1","1503675","696318","807357","86.2",
"동부","70~74세","2021 년","1566724","724422","842302","86","1549410","717086","832324","86.2",
"동부","70~74세","2022 년","1651936","765780","886156","86.4","1631113","756859","874254","86.6",
"동부","70~74세","2023 년","1701265","787157","914108","86.1","1677011","776870","900141","86.3",
"동부","75~79세","2015 년","913754","375959","537795","69.9","907983","373822","534161","70",
"동부","75~79세","2016 년","969180","404228","564952","71.6","963544","402285","561259","71.7",
"동부","75~79세","2017 년","1061903","449989","611914","73.5","1056293","448217","608076","73.7",
"동부","75~79세","2018 년","1105530","472463","633067","74.6","1099927","470738","629189","74.8",
"동부","75~79세","2019 년","1128836","485444","643392","75.5","1122733","483383","639350","75.6",
"동부","75~79세","2020 년","1145434","496117","649317","76.4","1138803","493965","644838","76.6",
"동부","75~79세","2021 년","1149025","501633","647392","77.5","1142362","499458","642904","77.7",
"동부","75~79세","2022 년","1178016","516609","661407","78.1","1169980","513880","656100","78.3",
"동부","75~79세","2023 년","1241993","547599","694394","78.9","1232591","544344","688247","79.1",
"동부","80~84세","2015 년","523437","179372","344065","52.1","520485","178355","342130","52.1",
"동부","80~84세","2016 년","573881","201199","372682","54","570714","200172","370542","54",
"동부","80~84세","2017 년","616464","221607","394857","56.1","613257","220695","392562","56.2",
"동부","80~84세","2018 년","663565","243501","420064","58","660101","242543","417558","58.1",
"동부","80~84세","2019 년","716153","268569","447584","60","712349","267438","444911","60.1",
"동부","80~84세","2020 년","755435","287773","467662","61.5","751108","286685","464423","61.7",
"동부","80~84세","2021 년","803958","311728","492230","63.3","799539","310607","488932","63.5",
"동부","80~84세","2022 년","885046","349006","536040","65.1","880146","347724","532422","65.3",
"동부","80~84세","2023 년","923903","367970","555933","66.2","918369","366459","551910","66.4",
"동부","85~89세","2015 년","240935","63626","177309","35.9","239667","63218","176449","35.8",
"동부","85~89세","2016 년","260254","69816","190438","36.7","258938","69430","189508","36.6",
"동부","85~89세","2017 년","281993","78027","203966","38.3","280781","77683","203098","38.2",
"동부","85~89세","2018 년","303323","86529","216794","39.9","302070","86229","215841","40",
"동부","85~89세","2019 년","331549","97391","234158","41.6","329938","96902","233036","41.6",
"동부","85~89세","2020 년","367906","111999","255907","43.8","366263","111604","254659","43.8",
"동부","85~89세","2021 년","403742","126260","277482","45.5","401923","125836","276087","45.6",
"동부","85~89세","2022 년","431227","138164","293063","47.1","429124","137662","291462","47.2",
"동부","85~89세","2023 년","466229","152976","313253","48.8","463603","152291","311312","48.9",
"동부","90~94세","2015 년","80613","18467","62146","29.7","80062","18289","61773","29.6",
"동부","90~94세","2016 년","85256","19097","66159","28.9","84717","18938","65779","28.8",
"동부","90~94세","2017 년","92811","20539","72272","28.4","92480","20450","72030","28.4",
"동부","90~94세","2018 년","101015","22223","78792","28.2","100693","22150","78543","28.2",
"동부","90~94세","2019 년","114399","25836","88563","29.2","113851","25660","88191","29.1",
"동부","90~94세","2020 년","127231","28656","98575","29.1","126783","28543","98240","29.1",
"동부","90~94세","2021 년","137174","31439","105735","29.7","136681","31330","105351","29.7",
"동부","90~94세","2022 년","146086","34683","111403","31.1","145504","34544","110960","31.1",
"동부","90~94세","2023 년","157074","38299","118775","32.2","156353","38121","118232","32.2",
"동부","95~99세","2015 년","16059","3271","12788","25.6","15866","3198","12668","25.2",
"동부","95~99세","2016 년","18273","3714","14559","25.5","18091","3641","14450","25.2",
"동부","95~99세","2017 년","20975","4298","16677","25.8","20883","4264","16619","25.7",
"동부","95~99세","2018 년","24072","5011","19061","26.3","24006","4992","19014","26.3",
"동부","95~99세","2019 년","25346","5195","20151","25.8","25165","5136","20029","25.6",
"동부","95~99세","2020 년","27415","5329","22086","24.1","27315","5302","22013","24.1",
"동부","95~99세","2021 년","28751","5358","23393","22.9","28622","5328","23294","22.9",
"동부","95~99세","2022 년","30344","5562","24782","22.4","30210","5526","24684","22.4",
"동부","95~99세","2023 년","33544","6101","27443","22.2","33414","6067","27347","22.2",
"동부","100세이상","2015 년","2089","300","1789","16.8","2037","282","1755","16.1",
"동부","100세이상","2016 년","2343","313","2030","15.4","2290","294","1996","14.7",
"동부","100세이상","2017 년","2644","393","2251","17.5","2611","380","2231","17",
"동부","100세이상","2018 년","2816","412","2404","17.1","2799","403","2396","16.8",
"동부","100세이상","2019 년","3249","556","2693","20.6","3200","534","2666","20",
"동부","100세이상","2020 년","3724","590","3134","18.8","3686","575","3111","18.5",
"동부","100세이상","2021 년","4318","718","3600","19.9","4278","701","3577","19.6",
"동부","100세이상","2022 년","4612","789","3823","20.6","4567","771","3796","20.3",
"동부","100세이상","2023 년","5025","906","4119","22","4964","883","4081","21.6",
"동부","15세미만","2015 년","5819523","3003060","2816463","106.6","5777206","2981313","2795893","106.6",
"동부","15세미만","2016 년","5699540","2937094","2762446","106.3","5652044","2912597","2739447","106.3",
"동부","15세미만","2017 년","5563139","2863175","2699964","106","5518721","2840477","2678244","106.1",
"동부","15세미만","2018 년","5443679","2799548","2644131","105.9","5389705","2772120","2617585","105.9",
"동부","15세미만","2019 년","5318154","2732982","2585172","105.7","5249947","2698200","2551747","105.7",
"동부","15세미만","2020 년","5200178","2670466","2529712","105.6","5133780","2636626","2497154","105.6",
"동부","15세미만","2021 년","5059992","2596724","2463268","105.4","4989805","2560959","2428846","105.4",
"동부","15세미만","2022 년","4894100","2510079","2384021","105.3","4819882","2472359","2347523","105.3",
"동부","15세미만","2023 년","4699406","2409387","2290019","105.2","4631331","2374790","2256541","105.2",
"동부","15~64세","2015 년","31177829","15790973","15386856","102.6","30275575","15304135","14971440","102.2",
"동부","15~64세","2016 년","31208044","15795887","15412157","102.5","30282610","15299378","14983232","102.1",
"동부","15~64세","2017 년","31094469","15738928","15355541","102.5","30119183","15219197","14899986","102.1",
"동부","15~64세","2018 년","31100481","15746153","15354328","102.6","30018680","15167380","14851300","102.1",
"동부","15~64세","2019 년","31039196","15712381","15326815","102.5","29891925","15099800","14792125","102.1",
"동부","15~64세","2020 년","30825634","15568777","15256857","102","29732848","15002828","14730020","101.9",
"동부","15~64세","2021 년","30582725","15452635","15130090","102.1","29526160","14910181","14615979","102",
"동부","15~64세","2022 년","30444758","15389217","15055541","102.2","29335791","14819544","14516247","102.1",
"동부","15~64세","2023 년","30287372","15323035","14964337","102.4","29088300","14697625","14390675","102.1",
"동부","65세이상","2015 년","4680343","1997863","2682480","74.5","4638665","1979678","2658987","74.5",
"동부","65세이상","2016 년","4860546","2080701","2779845","74.8","4816186","2061637","2754549","74.8",
"동부","65세이상","2017 년","5135432","2211237","2924195","75.6","5087054","2190691","2896363","75.6",
"동부","65세이상","2018 년","5371039","2319996","3051043","76","5317964","2297600","3020364","76.1",
"동부","65세이상","2019 년","5665755","2459912","3205843","76.7","5603745","2433193","3170552","76.7",
"동부","65세이상","2020 년","6039491","2631221","3408270","77.2","5968073","2601102","3366971","77.3",
"동부","65세이상","2021 년","6377064","2789964","3587100","77.8","6301791","2758021","3543770","77.8",
"동부","65세이상","2022 년","6748036","2965728","3782308","78.4","6660849","2928321","3732528","78.5",
"동부","65세이상","2023 년","7120272","3140077","3980195","78.9","7023201","3098801","3924400","79",
"동부","85세이상","2015 년","339696","85664","254032","33.7","337632","84987","252645","33.6",
"동부","85세이상","2016 년","366126","92940","273186","34","364036","92303","271733","34",
"동부","85세이상","2017 년","398423","103257","295166","35","396755","102777","293978","35",
"동부","85세이상","2018 년","431226","114175","317051","36","429568","113774","315794","36",
"동부","85세이상","2019 년","474543","128978","345565","37.3","472154","128232","343922","37.3",
"동부","85세이상","2020 년","526276","146574","379702","38.6","524047","146024","378023","38.6",
"동부","85세이상","2021 년","573985","163775","410210","39.9","571504","163195","408309","40",
"동부","85세이상","2022 년","612269","179198","433071","41.4","609405","178503","430902","41.4",
"동부","85세이상","2023 년","661872","198282","463590","42.8","658334","197362","460972","42.8",
"동부","평균연령","2015 년","39.4","38.4","40.5","","39.5","38.4","40.5","",
"동부","평균연령","2016 년","39.9","38.9","41","","39.9","38.9","41","",
"동부","평균연령","2017 년","40.5","39.4","41.5","","40.5","39.4","41.5","",
"동부","평균연령","2018 년","41","39.9","42","","41","40","42.1","",
"동부","평균연령","2019 년","41.5","40.4","42.5","","41.6","40.5","42.6","",
"동부","평균연령","2020 년","42","41","43","","42.1","41","43.1","",
"동부","평균연령","2021 년","42.6","41.5","43.6","","42.7","41.6","43.7","",
"동부","평균연령","2022 년","43.1","42.1","44.1","","43.2","42.1","44.3","",
"동부","평균연령","2023 년","43.7","42.6","44.7","","43.8","42.7","44.8","",
"동부","중위연령","2015 년","40.1","39","41.2","","40.2","39","41.2","",
"동부","중위연령","2016 년","40.7","39.5","41.8","","40.7","39.6","41.9","",
"동부","중위연령","2017 년","41.2","40","42.4","","41.3","40.2","42.5","",
"동부","중위연령","2018 년","41.7","40.5","43","","41.9","40.7","43.1","",
"동부","중위연령","2019 년","42.3","41.1","43.5","","42.5","41.3","43.7","",
"동부","중위연령","2020 년","42.8","41.6","44","","43","41.8","44.2","",
"동부","중위연령","2021 년","43.4","42.2","44.6","","43.6","42.4","44.9","",
"동부","중위연령","2022 년","43.9","42.8","45.2","","44.2","43","45.5","",
"동부","중위연령","2023 년","44.5","43.4","45.8","","44.8","43.7","46.1","",
"서울특별시","합계","2015 년","9904312","4859535","5044777","96.3","9567196","4694317","4872879","96.3",
"서울특별시","합계","2016 년","9805506","4799115","5006391","95.9","9470339","4636374","4833965","95.9",
"서울특별시","합계","2017 년","9741871","4757642","4984229","95.5","9397944","4592393","4805551","95.6",
"서울특별시","합계","2018 년","9673936","4718972","4954964","95.2","9299511","4536552","4762959","95.2",
"서울특별시","합계","2019 년","9639541","4690440","4949101","94.8","9249364","4500878","4748486","94.8",
"서울특별시","합계","2020 년","9586195","4647733","4938462","94.1","9219741","4474343","4745398","94.3",
"서울특별시","합계","2021 년","9472127","4584251","4887876","93.8","9125047","4421687","4703360","94",
"서울특별시","합계","2022 년","9417469","4547051","4870418","93.4","9056522","4381802","4674720","93.7",
"서울특별시","합계","2023 년","9384512","4523958","4860554","93.1","9018373","4357962","4660411","93.5",
"서울특별시","0~4세","2015 년","391765","200927","190838","105.3","384230","197029","187201","105.2",
"서울특별시","0~4세","2016 년","378946","194318","184628","105.2","371239","190370","180869","105.3",
"서울특별시","0~4세","2017 년","354174","181170","173004","104.7","346711","177401","169310","104.8",
"서울특별시","0~4세","2018 년","328817","168527","160290","105.1","320267","164216","156051","105.2",
"서울특별시","0~4세","2019 년","306901","157770","149131","105.8","296570","152446","144124","105.8",
"서울특별시","0~4세","2020 년","278869","143492","135377","106","269981","138917","131064","106",
"서울특별시","0~4세","2021 년","250141","128920","121221","106.4","243382","125436","117946","106.4",
"서울특별시","0~4세","2022 년","231340","119500","111840","106.8","225391","116412","108979","106.8",
"서울특별시","0~4세","2023 년","214730","110574","104156","106.2","210171","108236","101935","106.2",
"서울특별시","5~9세","2015 년","373253","191849","181404","105.8","367923","189058","178865","105.7",
"서울특별시","5~9세","2016 년","371005","190385","180620","105.4","365059","187265","177794","105.3",
"서울특별시","5~9세","2017 년","363637","186597","177040","105.4","359066","184234","174832","105.4",
"서울특별시","5~9세","2018 년","351631","180429","171202","105.4","346346","177716","168630","105.4",
"서울특별시","5~9세","2019 년","347642","178533","169109","105.6","340831","175038","165793","105.6",
"서울특별시","5~9세","2020 년","343206","176037","167169","105.3","336583","172634","163949","105.3",
"서울특별시","5~9세","2021 년","331179","169694","161485","105.1","323578","165820","157758","105.1",
"서울특별시","5~9세","2022 년","309932","158623","151309","104.8","302293","154720","147573","104.8",
"서울특별시","5~9세","2023 년","288832","147817","141015","104.8","283852","145299","138553","104.9",
"서울특별시","10~14세","2015 년","404973","209387","195586","107.1","401319","207475","193844","107",
"서울특별시","10~14세","2016 년","380447","196525","183922","106.9","376506","194431","182075","106.8",
"서울특별시","10~14세","2017 년","371556","191682","179874","106.6","368747","190196","178551","106.5",
"서울특별시","10~14세","2018 년","363181","187466","175715","106.7","359678","185675","174003","106.7",
"서울특별시","10~14세","2019 년","352373","181578","170795","106.3","348371","179550","168821","106.4",
"서울특별시","10~14세","2020 년","353042","181711","171331","106.1","349124","179708","169416","106.1",
"서울특별시","10~14세","2021 년","351446","180642","170804","105.8","347167","178449","168718","105.8",
"서울특별시","10~14세","2022 년","345853","177741","168112","105.7","341302","175448","165854","105.8",
"서울특별시","10~14세","2023 년","336795","173142","163653","105.8","332629","171074","161555","105.9",
"서울특별시","15~19세","2015 년","551140","281128","270012","104.1","543083","277732","265351","104.7",
"서울특별시","15~19세","2016 년","526432","267296","259136","103.1","516892","263408","253484","103.9",
"서울특별시","15~19세","2017 년","496075","251735","244340","103","486459","247939","238520","103.9",
"서울특별시","15~19세","2018 년","465785","235494","230291","102.3","455469","231225","224244","103.1",
"서울특별시","15~19세","2019 년","443224","222941","220283","101.2","431953","218491","213462","102.4",
"서울특별시","15~19세","2020 년","408748","206091","202657","101.7","401028","203117","197911","102.6",
"서울특별시","15~19세","2021 년","382368","192797","189571","101.7","375229","190154","185075","102.7",
"서울특별시","15~19세","2022 년","377893","190040","187853","101.2","368224","186424","181800","102.5",
"서울특별시","15~19세","2023 년","374406","188068","186338","100.9","363941","184091","179850","102.4",
"서울특별시","20~24세","2015 년","711944","352341","359603","98","681199","340607","340592","100",
"서울특별시","20~24세","2016 년","707555","346503","361052","96","673957","334376","339581","98.5",
"서울특별시","20~24세","2017 년","699945","338539","361406","93.7","661569","325097","336472","96.6",
"서울특별시","20~24세","2018 년","691954","330203","361751","91.3","645569","312686","332883","93.9",
"서울특별시","20~24세","2019 년","681005","319500","361505","88.4","630814","300486","330328","91",
"서울특별시","20~24세","2020 년","664188","308209","355979","86.6","625922","294271","331651","88.7",
"서울특별시","20~24세","2021 년","638048","293222","344826","85","599600","280267","319333","87.8",
"서울특별시","20~24세","2022 년","612987","278436","334551","83.2","565833","263540","302293","87.2",
"서울특별시","20~24세","2023 년","589635","266615","323020","82.5","542883","251954","290929","86.6",
"서울특별시","25~29세","2015 년","765654","377599","388055","97.3","722350","356908","365442","97.7",
"서울특별시","25~29세","2016 년","761584","375184","386400","97.1","720334","356094","364240","97.8",
"서울특별시","25~29세","2017 년","777218","383505","393713","97.4","735323","364581","370742","98.3",
"서울특별시","25~29세","2018 년","799023","395630","403393","98.1","755906","375910","379996","98.9",
"서울특별시","25~29세","2019 년","821238","405143","416095","97.4","777456","385270","392186","98.2",
"서울특별시","25~29세","2020 년","835286","406953","428333","95","795700","390712","404988","96.5",
"서울특별시","25~29세","2021 년","832518","402877","429641","93.8","795367","388194","407173","95.3",
"서울특별시","25~29세","2022 년","826149","395825","430324","92","785912","380576","405336","93.9",
"서울특별시","25~29세","2023 년","818359","387526","430833","89.9","775262","371655","403607","92.1",
"서울특별시","30~34세","2015 년","857426","432854","424572","102","823935","415257","408678","101.6",
"서울특별시","30~34세","2016 년","807246","405165","402081","100.8","772614","387306","385308","100.5",
"서울특별시","30~34세","2017 년","766607","384052","382555","100.4","727683","363965","363718","100.1",
"서울특별시","30~34세","2018 년","738359","369944","368415","100.4","696267","348197","348070","100",
"서울특별시","30~34세","2019 년","729069","364799","364270","100.1","685989","342943","343046","100",
"서울특별시","30~34세","2020 년","734952","367172","367780","99.8","692702","346673","346029","100.2",
"서울특별시","30~34세","2021 년","736967","367728","369239","99.6","699372","349939","349433","100.1",
"서울특별시","30~34세","2022 년","756436","378100","378336","99.9","720569","361545","359024","100.7",
"서울특별시","30~34세","2023 년","778852","390430","388422","100.5","743207","374283","368924","101.5",
"서울특별시","35~39세","2015 년","793411","401512","391899","102.5","767625","386917","380708","101.6",
"서울특별시","35~39세","2016 년","798944","403974","394970","102.3","773379","389706","383673","101.6",
"서울특별시","35~39세","2017 년","806213","407731","398482","102.3","777632","391846","385786","101.6",
"서울특별시","35~39세","2018 년","804461","407004","397457","102.4","772520","389408","383112","101.6",
"서울특별시","35~39세","2019 년","778838","393596","385242","102.2","745331","375341","369990","101.4",
"서울특별시","35~39세","2020 년","745117","375820","369297","101.8","711638","358471","353167","101.5",
"서울특별시","35~39세","2021 년","706701","355541","351160","101.2","673812","338518","335294","101",
"서울특별시","35~39세","2022 년","673243","338321","334922","101","640145","321338","318807","100.8",
"서울특별시","35~39세","2023 년","654497","328810","325687","101","619843","311081","308762","100.8",
"서울특별시","40~44세","2015 년","836876","421126","415750","101.3","809045","405627","403418","100.5",
"서울특별시","40~44세","2016 년","789416","396847","392569","101.1","764037","382466","381571","100.2",
"서울특별시","40~44세","2017 년","756546","378503","378043","100.1","732028","364563","367465","99.2",
"서울특별시","40~44세","2018 년","720732","360945","359787","100.3","694455","345987","348468","99.3",
"서울특별시","40~44세","2019 년","705535","352718","352817","100","678136","337292","340844","99",
"서울특별시","40~44세","2020 년","709736","353683","356053","99.3","682858","339144","343714","98.7",
"서울특별시","40~44세","2021 년","714467","356604","357863","99.6","688927","342895","346032","99.1",
"서울특별시","40~44세","2022 년","720845","360369","360476","100","694240","346290","347950","99.5",
"서울특별시","40~44세","2023 년","724780","362514","362266","100.1","696640","347871","348769","99.7",
"서울특별시","45~49세","2015 년","824198","406727","417471","97.4","789836","389179","400657","97.1",
"서울특별시","45~49세","2016 년","842448","414847","427601","97","809914","398078","411836","96.7",
"서울특별시","45~49세","2017 년","847475","419571","427904","98.1","814828","402561","412267","97.6",
"서울특별시","45~49세","2018 년","835977","414897","421080","98.5","801944","396529","405415","97.8",
"서울특별시","45~49세","2019 년","817450","406212","411238","98.8","784288","388140","396148","98",
"서울특별시","45~49세","2020 년","783563","388580","394983","98.4","754043","372828","381215","97.8",
"서울특별시","45~49세","2021 년","736451","365576","370875","98.6","710486","351502","358984","97.9",
"서울특별시","45~49세","2022 년","706120","349142","356978","97.8","681939","336047","345892","97.2",
"서울특별시","45~49세","2023 년","677141","335295","341846","98.1","652400","322092","330308","97.5",
"서울특별시","50~54세","2015 년","806399","393503","412896","95.3","766683","374483","392200","95.5",
"서울특별시","50~54세","2016 년","773918","380832","393086","96.9","734368","361428","372940","96.9",
"서울특별시","50~54세","2017 년","756194","370127","386067","95.9","719563","352153","367410","95.8",
"서울특별시","50~54세","2018 년","757187","370282","386905","95.7","720312","351708","368604","95.4",
"서울특별시","50~54세","2019 년","769856","376654","393202","95.8","733888","358203","375685","95.3",
"서울특별시","50~54세","2020 년","773582","378429","395153","95.8","739434","361142","378292","95.5",
"서울특별시","50~54세","2021 년","789330","385892","403438","95.7","756912","369219","387693","95.2",
"서울특별시","50~54세","2022 년","794846","390992","403854","96.8","762320","374022","388298","96.3",
"서울특별시","50~54세","2023 년","787621","388356","399265","97.3","755313","371435","383878","96.8",
"서울특별시","55~59세","2015 년","783847","374379","409468","91.4","748820","357561","391259","91.4",
"서울특별시","55~59세","2016 년","795249","379327","415922","91.2","763943","364202","399741","91.1",
"서울특별시","55~59세","2017 년","790279","378648","411631","92","760079","364292","395787","92",
"서울특별시","55~59세","2018 년","786431","378116","408315","92.6","750422","360520","389902","92.5",
"서울특별시","55~59세","2019 년","769236","371525","397711","93.4","731534","352865","378669","93.2",
"서울특별시","55~59세","2020 년","743817","360318","383499","94","706269","341957","364312","93.9",
"서울특별시","55~59세","2021 년","712584","348429","364155","95.7","675899","330108","345791","95.5",
"서울특별시","55~59세","2022 년","700391","340868","359523","94.8","665451","323438","342013","94.6",
"서울특별시","55~59세","2023 년","702345","340868","361477","94.3","669365","324283","345082","94",
"서울특별시","60~64세","2015 년","582420","277581","304839","91.1","558254","265613","292641","90.8",
"서울특별시","60~64세","2016 년","624370","296875","327495","90.7","598732","284156","314576","90.3",
"서울특별시","60~64세","2017 년","645887","306492","339395","90.3","617823","292599","325224","90",
"서울특별시","60~64세","2018 년","673923","320123","353800","90.5","644797","305781","339016","90.2",
"서울특별시","60~64세","2019 년","697227","330631","366596","90.2","668037","316264","351773","89.9",
"서울특별시","60~64세","2020 년","712641","337235","375406","89.8","681960","322405","359555","89.7",
"서울특별시","60~64세","2021 년","725537","343100","382437","89.7","698385","329934","368451","89.5",
"서울특별시","60~64세","2022 년","722186","342785","379401","90.3","694649","329378","365271","90.2",
"서울특별시","60~64세","2023 년","721895","344134","377761","91.1","691851","329485","362366","90.9",
"서울특별시","65~69세","2015 년","445487","210905","234582","89.9","435732","206299","229433","89.9",
"서울특별시","65~69세","2016 년","445759","210655","235104","89.6","435313","205629","229684","89.5",
"서울특별시","65~69세","2017 년","458490","216809","241681","89.7","446771","211180","235591","89.6",
"서울특별시","65~69세","2018 년","463507","218200","245307","88.9","450779","212039","238740","88.8",
"서울특별시","65~69세","2019 년","481211","226481","254730","88.9","466998","219693","247305","88.8",
"서울특별시","65~69세","2020 년","520889","243941","276948","88.1","504509","236100","268409","88",
"서울특별시","65~69세","2021 년","559016","261152","297864","87.7","542479","253206","289273","87.5",
"서울특별시","65~69세","2022 년","581371","270944","310427","87.3","563007","262065","300942","87.1",
"서울특별시","65~69세","2023 년","610481","284414","326067","87.2","591181","275209","315972","87.1",
"서울특별시","70~74세","2015 년","341116","160465","180651","88.8","337519","158969","178550","89",
"서울특별시","70~74세","2016 년","340467","159146","181321","87.8","336992","157699","179293","88",
"서울특별시","70~74세","2017 년","346471","160386","186085","86.2","342908","158941","183967","86.4",
"서울특별시","70~74세","2018 년","360011","166087","193924","85.6","356109","164528","191581","85.9",
"서울특별시","70~74세","2019 년","377160","173395","203765","85.1","372271","171356","200915","85.3",
"서울특별시","70~74세","2020 년","391970","179983","211987","84.9","386271","177553","208718","85.1",
"서울특별시","70~74세","2021 년","394383","181034","213349","84.9","388323","178387","209936","85",
"서울특별시","70~74세","2022 년","408388","187594","220794","85","401186","184391","216795","85.1",
"서울특별시","70~74세","2023 년","417125","191019","226106","84.5","408967","187399","221568","84.6",
"서울특별시","75~79세","2015 년","228694","99738","128956","77.3","226204","98840","127364","77.6",
"서울특별시","75~79세","2016 년","242974","107446","135528","79.3","240627","106687","133940","79.7",
"서울특별시","75~79세","2017 년","268057","120169","147888","81.3","265755","119498","146257","81.7",
"서울특별시","75~79세","2018 년","278840","125514","153326","81.9","276612","124859","151753","82.3",
"서울특별시","75~79세","2019 년","285466","128585","156881","82","283214","127835","155379","82.3",
"서울특별시","75~79세","2020 년","290634","130667","159967","81.7","288272","129924","158348","82",
"서울특별시","75~79세","2021 년","292472","130873","161599","81","290174","130118","160056","81.3",
"서울특별시","75~79세","2022 년","300174","133365","166809","80","297545","132459","165086","80.2",
"서울특별시","75~79세","2023 년","315444","139886","175558","79.7","312445","138864","173581","80",
"서울특별시","80~84세","2015 년","123565","45105","78460","57.5","122259","44673","77586","57.6",
"서울특별시","80~84세","2016 년","133706","50285","83421","60.3","132351","49862","82489","60.4",
"서울특별시","80~84세","2017 년","145012","55768","89244","62.5","143708","55411","88297","62.8",
"서울특별시","80~84세","2018 년","156237","61459","94778","64.8","154865","61090","93775","65.1",
"서울특별시","80~84세","2019 년","169625","68264","101361","67.3","168147","67840","100307","67.6",
"서울특별시","80~84세","2020 년","179109","73254","105855","69.2","177482","72859","104623","69.6",
"서울특별시","80~84세","2021 년","191672","79801","111871","71.3","190071","79417","110654","71.8",
"서울특별시","80~84세","2022 년","213007","90038","122969","73.2","211293","89606","121687","73.6",
"서울특별시","80~84세","2023 년","223718","94985","128733","73.8","221850","94484","127366","74.2",
"서울특별시","85~89세","2015 년","57673","16375","41298","39.7","57092","16189","40903","39.6",
"서울특별시","85~89세","2016 년","59914","17431","42483","41","59317","17258","42059","41",
"서울특별시","85~89세","2017 년","64679","19627","45052","43.6","64162","19476","44686","43.6",
"서울특별시","85~89세","2018 년","68170","21507","46663","46.1","67670","21385","46285","46.2",
"서울특별시","85~89세","2019 년","73786","23907","49879","47.9","73138","23718","49420","48",
"서울특별시","85~89세","2020 년","81514","27285","54229","50.3","80876","27124","53752","50.5",
"서울특별시","85~89세","2021 년","89382","30895","58487","52.8","88701","30731","57970","53",
"서울특별시","85~89세","2022 년","96560","33960","62600","54.2","95787","33778","62009","54.5",
"서울특별시","85~89세","2023 년","105306","38090","67216","56.7","104384","37849","66535","56.9",
"서울특별시","90~94세","2015 년","19795","4965","14830","33.5","19537","4876","14661","33.3",
"서울특별시","90~94세","2016 년","20085","4909","15176","32.3","19842","4833","15009","32.2",
"서울특별시","90~94세","2017 년","21748","5267","16481","32","21586","5219","16367","31.9",
"서울특별시","90~94세","2018 년","23407","5654","17753","31.8","23263","5619","17644","31.8",
"서울특별시","90~94세","2019 년","25898","6565","19333","34","25702","6500","19202","33.9",
"서울특별시","90~94세","2020 년","28197","7234","20963","34.5","28028","7189","20839","34.5",
"서울특별시","90~94세","2021 년","30015","7814","22201","35.2","29816","7761","22055","35.2",
"서울특별시","90~94세","2022 년","31845","8696","23149","37.6","31627","8643","22984","37.6",
"서울특별시","90~94세","2023 년","33881","9509","24372","39","33618","9447","24171","39.1",
"서울특별시","95~99세","2015 년","4133","970","3163","30.7","4036","935","3101","30.2",
"서울특별시","95~99세","2016 년","4448","1074","3374","31.8","4358","1037","3321","31.2",
"서울특별시","95~99세","2017 년","4943","1142","3801","30","4900","1126","3774","29.8",
"서울특별시","95~99세","2018 년","5626","1363","4263","32","5594","1351","4243","31.8",
"서울특별시","95~99세","2019 년","6012","1485","4527","32.8","5938","1461","4477","32.6",
"서울특별시","95~99세","2020 년","6251","1468","4783","30.7","6203","1454","4749","30.6",
"서울특별시","95~99세","2021 년","6463","1435","5028","28.5","6407","1419","4988","28.4",
"서울특별시","95~99세","2022 년","6858","1479","5379","27.5","6792","1461","5331","27.4",
"서울특별시","95~99세","2023 년","7475","1622","5853","27.7","7414","1603","5811","27.6",
"서울특별시","100세이상","2015 년","543","99","444","22.3","515","90","425","21.2",
"서울특별시","100세이상","2016 년","593","91","502","18.1","565","83","482","17.2",
"서울특별시","100세이상","2017 년","665","122","543","22.5","643","115","528","21.8",
"서울특별시","100세이상","2018 년","677","128","549","23.3","667","123","544","22.6",
"서울특별시","100세이상","2019 년","789","158","631","25","758","146","612","23.9",
"서울특별시","100세이상","2020 년","884","171","713","24","858","161","697","23.1",
"서울특별시","100세이상","2021 년","987","225","762","29.5","960","213","747","28.5",
"서울특별시","100세이상","2022 년","1045","233","812","28.7","1017","221","796","27.8",
"서울특별시","100세이상","2023 년","1194","284","910","31.2","1157","268","889","30.1",
"서울특별시","15세미만","2015 년","1169991","602163","567828","106","1153472","593562","559910","106",
"서울특별시","15세미만","2016 년","1130398","581228","549170","105.8","1112804","572066","540738","105.8",
"서울특별시","15세미만","2017 년","1089367","559449","529918","105.6","1074524","551831","522693","105.6",
"서울특별시","15세미만","2018 년","1043629","536422","507207","105.8","1026291","527607","498684","105.8",
"서울특별시","15세미만","2019 년","1006916","517881","489035","105.9","985772","507034","478738","105.9",
"서울특별시","15세미만","2020 년","975117","501240","473877","105.8","955688","491259","464429","105.8",
"서울특별시","15세미만","2021 년","932766","479256","453510","105.7","914127","469705","444422","105.7",
"서울특별시","15세미만","2022 년","887125","455864","431261","105.7","868986","446580","422406","105.7",
"서울특별시","15세미만","2023 년","840357","431533","408824","105.6","826652","424609","402043","105.6",
"서울특별시","15~64세","2015 년","7513315","3718750","3794565","98","7210830","3569884","3640946","98",
"서울특별시","15~64세","2016 년","7427162","3666850","3760312","97.5","7128170","3521220","3606950","97.6",
"서울특별시","15~64세","2017 년","7342439","3618903","3723536","97.2","7032987","3469596","3563391","97.4",
"서울특별시","15~64세","2018 년","7273832","3582638","3691194","97.1","6937661","3417951","3519710","97.1",
"서울특별시","15~64세","2019 년","7212678","3543719","3668959","96.6","6867426","3375295","3492131","96.7",
"서울특별시","15~64세","2020 년","7111630","3482490","3629140","96","6791554","3330720","3460834","96.2",
"서울특별시","15~64세","2021 년","6974971","3411766","3563205","95.7","6673989","3270730","3403259","96.1",
"서울특별시","15~64세","2022 년","6891096","3364878","3526218","95.4","6579282","3222598","3356684","96",
"서울특별시","15~64세","2023 년","6829531","3332616","3496915","95.3","6510705","3188230","3322475","96",
"서울특별시","65세이상","2015 년","1221006","538622","682384","78.9","1202894","530871","672023","79",
"서울특별시","65세이상","2016 년","1247946","551037","696909","79.1","1229365","543088","686277","79.1",
"서울특별시","65세이상","2017 년","1310065","579290","730775","79.3","1290433","570966","719467","79.4",
"서울특별시","65세이상","2018 년","1356475","599912","756563","79.3","1335559","590994","744565","79.4",
"서울특별시","65세이상","2019 년","1419947","628840","791107","79.5","1396166","618549","777617","79.5",
"서울특별시","65세이상","2020 년","1499448","664003","835445","79.5","1472499","652364","820135","79.5",
"서울특별시","65세이상","2021 년","1564390","693229","871161","79.6","1536931","681252","855679","79.6",
"서울특별시","65세이상","2022 년","1639248","726309","912939","79.6","1608254","712624","895630","79.6",
"서울특별시","65세이상","2023 년","1714624","759809","954815","79.6","1681016","745123","935893","79.6",
"서울특별시","85세이상","2015 년","82144","22409","59735","37.5","81180","22090","59090","37.4",
"서울특별시","85세이상","2016 년","85040","23505","61535","38.2","84082","23211","60871","38.1",
"서울특별시","85세이상","2017 년","92035","26158","65877","39.7","91291","25936","65355","39.7",
"서울특별시","85세이상","2018 년","97880","28652","69228","41.4","97194","28478","68716","41.4",
"서울특별시","85세이상","2019 년","106485","32115","74370","43.2","105536","31825","73711","43.2",
"서울특별시","85세이상","2020 년","116846","36158","80688","44.8","115965","35928","80037","44.9",
"서울특별시","85세이상","2021 년","126847","40369","86478","46.7","125884","40124","85760","46.8",
"서울특별시","85세이상","2022 년","136308","44368","91940","48.3","135223","44103","91120","48.4",
"서울특별시","85세이상","2023 년","147856","49505","98351","50.3","146573","49167","97406","50.5",
"서울특별시","평균연령","2015 년","40.5","39.7","41.4","","40.5","39.6","41.4","",
"서울특별시","평균연령","2016 년","41","40.2","41.8","","41","40.1","41.8","",
"서울특별시","평균연령","2017 년","41.5","40.6","42.2","","41.5","40.6","42.3","",
"서울특별시","평균연령","2018 년","41.9","41.1","42.7","","42","41.1","42.8","",
"서울특별시","평균연령","2019 년","42.4","41.6","43.2","","42.5","41.7","43.3","",
"서울특별시","평균연령","2020 년","42.9","42.1","43.6","","42.9","42.1","43.7","",
"서울특별시","평균연령","2021 년","43.4","42.6","44.1","","43.5","42.7","44.2","",
"서울특별시","평균연령","2022 년","43.9","43.1","44.6","","44","43.2","44.8","",
"서울특별시","평균연령","2023 년","44.4","43.6","45","","44.5","43.7","45.2","",
"서울특별시","중위연령","2015 년","40.7","39.8","41.5","","40.6","39.7","41.5","",
"서울특별시","중위연령","2016 년","41.2","40.3","42.1","","41.2","40.2","42.1","",
"서울특별시","중위연령","2017 년","41.6","40.7","42.5","","41.7","40.7","42.6","",
"서울특별시","중위연령","2018 년","42.1","41.2","43","","42.2","41.3","43.2","",
"서울특별시","중위연령","2019 년","42.5","41.7","43.4","","42.7","41.8","43.6","",
"서울특별시","중위연령","2020 년","42.9","42.1","43.8","","43.1","42.1","43.9","",
"서울특별시","중위연령","2021 년","43.4","42.7","44.2","","43.6","42.7","44.5","",
"서울특별시","중위연령","2022 년","43.9","43.2","44.7","","44.1","43.2","45","",
"서울특별시","중위연령","2023 년","44.4","43.7","45.1","","44.6","43.7","45.4","",
"부산광역시","합계","2015 년","3448737","1701347","1747390","97.4","3404667","1675339","1729328","96.9",
"부산광역시","합계","2016 년","3440484","1694026","1746458","97","3394316","1667106","1727210","96.5",
"부산광역시","합계","2017 년","3416918","1680933","1735985","96.8","3368110","1652803","1715307","96.4",
"부산광역시","합계","2018 년","3395278","1668984","1726294","96.7","3339772","1637363","1702409","96.2",
"부산광역시","합계","2019 년","3372692","1655566","1717126","96.4","3312190","1621545","1690645","95.9",
"부산광역시","합계","2020 년","3349016","1638751","1710265","95.8","3294102","1608877","1685225","95.5",
"부산광역시","합계","2021 년","3324335","1624745","1699590","95.6","3271001","1596087","1674914","95.3",
"부산광역시","합계","2022 년","3295760","1608947","1686813","95.4","3239787","1578621","1661166","95",
"부산광역시","합계","2023 년","3279604","1600281","1679323","95.3","3216548","1565303","1651245","94.8",
"부산광역시","0~4세","2015 년","133233","68404","64829","105.5","132712","68139","64573","105.5",
"부산광역시","0~4세","2016 년","131709","67732","63977","105.9","131194","67473","63721","105.9",
"부산광역시","0~4세","2017 년","124080","63735","60345","105.6","123600","63501","60099","105.7",
"부산광역시","0~4세","2018 년","117270","60290","56980","105.8","116669","59985","56684","105.8",
"부산광역시","0~4세","2019 년","108650","55707","52943","105.2","107869","55330","52539","105.3",
"부산광역시","0~4세","2020 년","98637","50511","48126","105","97921","50159","47762","105",
"부산광역시","0~4세","2021 년","89025","45642","43383","105.2","88406","45331","43075","105.2",
"부산광역시","0~4세","2022 년","81941","42012","39929","105.2","81303","41684","39619","105.2",
"부산광역시","0~4세","2023 년","75875","38921","36954","105.3","75309","38623","36686","105.3",
"부산광역시","5~9세","2015 년","128013","65968","62045","106.3","127538","65730","61808","106.3",
"부산광역시","5~9세","2016 년","131323","67440","63883","105.6","130823","67179","63644","105.6",
"부산광역시","5~9세","2017 년","131344","67540","63804","105.9","131043","67393","63650","105.9",
"부산광역시","5~9세","2018 년","130641","67067","63574","105.5","130248","66874","63374","105.5",
"부산광역시","5~9세","2019 년","131200","67395","63805","105.6","130691","67164","63527","105.7",
"부산광역시","5~9세","2020 년","131903","67628","64275","105.2","131420","67408","64012","105.3",
"부산광역시","5~9세","2021 년","129223","66301","62922","105.4","128575","66002","62573","105.5",
"부산광역시","5~9세","2022 년","122846","62939","59907","105.1","122165","62623","59542","105.2",
"부산광역시","5~9세","2023 년","116568","59826","56742","105.4","116087","59566","56521","105.4",
"부산광역시","10~14세","2015 년","142028","73952","68076","108.6","141613","73738","67875","108.6",
"부산광역시","10~14세","2016 년","132615","68828","63787","107.9","132205","68629","63576","107.9",
"부산광역시","10~14세","2017 년","129597","67142","62455","107.5","129336","67018","62318","107.5",
"부산광역시","10~14세","2018 년","127020","65535","61485","106.6","126712","65384","61328","106.6",
"부산광역시","10~14세","2019 년","124504","64129","60375","106.2","124150","63960","60190","106.3",
"부산광역시","10~14세","2020 년","126187","65022","61165","106.3","125846","64857","60989","106.3",
"부산광역시","10~14세","2021 년","129029","66262","62767","105.6","128694","66093","62601","105.6",
"부산광역시","10~14세","2022 년","130198","66930","63268","105.8","129791","66731","63060","105.8",
"부산광역시","10~14세","2023 년","129766","66644","63122","105.6","129389","66439","62950","105.5",
"부산광역시","15~19세","2015 년","204961","107728","97233","110.8","203673","107142","96531","111",
"부산광역시","15~19세","2016 년","194712","101759","92953","109.5","192942","100929","92013","109.7",
"부산광역시","15~19세","2017 년","182238","95018","87220","108.9","180155","94050","86105","109.2",
"부산광역시","15~19세","2018 년","170236","88659","81577","108.7","167691","87409","80282","108.9",
"부산광역시","15~19세","2019 년","159525","82794","76731","107.9","157152","81706","75446","108.3",
"부산광역시","15~19세","2020 년","144199","74893","69306","108.1","142835","74287","68548","108.4",
"부산광역시","15~19세","2021 년","133751","69252","64499","107.4","132658","68801","63857","107.7",
"부산광역시","15~19세","2022 년","131316","67720","63596","106.5","129862","67040","62822","106.7",
"부산광역시","15~19세","2023 년","131007","67257","63750","105.5","128616","66134","62482","105.8",
"부산광역시","20~24세","2015 년","248602","132959","115643","115","241138","129272","111866","115.6",
"부산광역시","20~24세","2016 년","245825","130739","115086","113.6","237733","126904","110829","114.5",
"부산광역시","20~24세","2017 년","240049","126463","113586","111.3","231153","122182","108971","112.1",
"부산광역시","20~24세","2018 년","234572","123137","111435","110.5","223664","117664","106000","111",
"부산광역시","20~24세","2019 년","226140","118208","107932","109.5","214191","112218","101973","110",
"부산광역시","20~24세","2020 년","218047","112542","105505","106.7","208516","107823","100693","107.1",
"부산광역시","20~24세","2021 년","208829","107261","101568","105.6","199849","102976","96873","106.3",
"부산광역시","20~24세","2022 년","194156","100034","94122","106.3","184910","95577","89333","107",
"부산광역시","20~24세","2023 년","184866","95236","89630","106.3","174252","89982","84270","106.8",
"부산광역시","25~29세","2015 년","212741","111618","101123","110.4","203729","105996","97733","108.5",
"부산광역시","25~29세","2016 년","213370","111928","101442","110.3","204407","106383","98024","108.5",
"부산광역시","25~29세","2017 년","218670","115467","103203","111.9","209493","109902","99591","110.4",
"부산광역시","25~29세","2018 년","223464","118685","104779","113.3","213372","112650","100722","111.8",
"부산광역시","25~29세","2019 년","225555","119893","105662","113.5","215018","113759","101259","112.3",
"부산광역시","25~29세","2020 년","226843","119788","107055","111.9","217205","114449","102756","111.4",
"부산광역시","25~29세","2021 년","225547","118753","106794","111.2","216226","113654","102572","110.8",
"부산광역시","25~29세","2022 년","218324","114162","104162","109.6","208529","108765","99764","109",
"부산광역시","25~29세","2023 년","210961","109669","101292","108.3","200255","103581","96674","107.1",
"부산광역시","30~34세","2015 년","239683","123727","115956","106.7","232762","118895","113867","104.4",
"부산광역시","30~34세","2016 년","224194","115989","108205","107.2","216764","110921","105843","104.8",
"부산광역시","30~34세","2017 년","208550","107923","100627","107.3","200554","102627","97927","104.8",
"부산광역시","30~34세","2018 년","197580","102511","95069","107.8","188522","96711","91811","105.3",
"부산광역시","30~34세","2019 년","192974","100218","92756","108","183285","94183","89102","105.7",
"부산광역시","30~34세","2020 년","192718","100029","92689","107.9","183399","94489","88910","106.3",
"부산광역시","30~34세","2021 년","195096","101304","93792","108","186247","96125","90122","106.7",
"부산광역시","30~34세","2022 년","201175","104898","96277","109","192116","99505","92611","107.4",
"부산광역시","30~34세","2023 년","206459","108414","98045","110.6","196433","102257","94176","108.6",
"부산광역시","35~39세","2015 년","245563","126063","119500","105.5","240788","122733","118055","104",
"부산광역시","35~39세","2016 년","253126","130038","123088","105.6","248134","126590","121544","104.2",
"부산광역시","35~39세","2017 년","255424","131196","124228","105.6","249880","127445","122435","104.1",
"부산광역시","35~39세","2018 년","253798","130059","123739","105.1","247250","125812","121438","103.6",
"부산광역시","35~39세","2019 년","242964","124675","118289","105.4","235580","120014","115566","103.8",
"부산광역시","35~39세","2020 년","227062","116286","110776","105","219837","111880","107957","103.6",
"부산광역시","35~39세","2021 년","212116","108897","103219","105.5","204935","104626","100309","104.3",
"부산광역시","35~39세","2022 년","198745","102180","96565","105.8","191196","97665","93531","104.4",
"부산광역시","35~39세","2023 년","190244","98253","91991","106.8","181660","93001","88659","104.9",
"부산광역시","40~44세","2015 년","268002","134657","133345","101","264247","132155","132092","100",
"부산광역시","40~44세","2016 년","254784","128753","126031","102.2","250986","126276","124710","101.3",
"부산광역시","40~44세","2017 년","244934","123941","120993","102.4","240997","121441","119556","101.6",
"부산광역시","40~44세","2018 년","236317","120333","115984","103.7","231875","117597","114278","102.9",
"부산광역시","40~44세","2019 년","232814","118424","114390","103.5","227885","115456","112429","102.7",
"부산광역시","40~44세","2020 년","236830","120485","116345","103.6","232022","117674","114348","102.9",
"부산광역시","40~44세","2021 년","243155","123791","119364","103.7","238335","120956","117379","103",
"부산광역시","40~44세","2022 년","246962","125754","121208","103.8","241713","122677","119036","103.1",
"부산광역시","40~44세","2023 년","247355","125768","121587","103.4","241346","122194","119152","102.6",
"부산광역시","45~49세","2015 년","282139","137543","144596","95.1","279247","135950","143297","94.9",
"부산광역시","45~49세","2016 년","284928","138850","146078","95.1","281834","137103","144731","94.7",
"부산광역시","45~49세","2017 년","282671","139262","143409","97.1","279391","137409","141982","96.8",
"부산광역시","45~49세","2018 년","276778","137022","139756","98","273156","134967","138189","97.7",
"부산광역시","45~49세","2019 년","270887","134865","136022","99.1","266775","132490","134285","98.7",
"부산광역시","45~49세","2020 년","260800","129863","130937","99.2","257136","127837","129299","98.9",
"부산광역시","45~49세","2021 년","246880","123585","123295","100.2","243304","121644","121660","100",
"부산광역시","45~49세","2022 년","238052","119346","118706","100.5","234329","117332","116997","100.3",
"부산광역시","45~49세","2023 년","230346","116255","114091","101.9","226271","114026","112245","101.6",
"부산광역시","50~54세","2015 년","295246","141969","153277","92.6","292886","140813","152073","92.6",
"부산광역시","50~54세","2016 년","279576","135609","143967","94.2","277088","134359","142729","94.1",
"부산광역시","50~54세","2017 년","270775","130892","139883","93.6","268165","129522","138643","93.4",
"부산광역시","50~54세","2018 년","269069","129854","139215","93.3","266478","128547","137931","93.2",
"부산광역시","50~54세","2019 년","272717","131636","141081","93.3","269829","130086","139743","93.1",
"부산광역시","50~54세","2020 년","273734","132689","141045","94.1","270923","131303","139620","94",
"부산광역시","50~54세","2021 년","275962","133756","142206","94.1","273058","132276","140782","94",
"부산광역시","50~54세","2022 년","274172","134160","140012","95.8","271211","132642","138569","95.7",
"부산광역시","50~54세","2023 년","269435","132388","137047","96.6","266068","130632","135436","96.5",
"부산광역시","55~59세","2015 년","308539","147484","161055","91.6","306735","146659","160076","91.6",
"부산광역시","55~59세","2016 년","315908","150135","165773","90.6","314199","149308","164891","90.5",
"부산광역시","55~59세","2017 년","313603","149182","164421","90.7","311816","148322","163494","90.7",
"부산광역시","55~59세","2018 년","308391","146553","161838","90.6","306445","145628","160817","90.6",
"부산광역시","55~59세","2019 년","296549","141227","155322","90.9","294389","140146","154243","90.9",
"부산광역시","55~59세","2020 년","281623","134264","147359","91.1","279631","133324","146307","91.1",
"부산광역시","55~59세","2021 년","266432","128220","138212","92.8","264353","127209","137144","92.8",
"부산광역시","55~59세","2022 년","259060","124174","134886","92.1","256957","123141","133816","92",
"부산광역시","55~59세","2023 년","259256","124080","135176","91.8","256860","122890","133970","91.7",
"부산광역시","60~64세","2015 년","239182","114660","124522","92.1","238013","114077","123936","92",
"부산광역시","60~64세","2016 년","254676","121730","132946","91.6","253414","121093","132321","91.5",
"부산광역시","60~64세","2017 년","264249","125995","138254","91.1","262942","125336","137606","91.1",
"부산광역시","60~64세","2018 년","276347","131953","144394","91.4","275048","131314","143734","91.4",
"부산광역시","60~64세","2019 년","285494","135149","150345","89.9","284124","134484","149640","89.9",
"부산광역시","60~64세","2020 년","291543","137595","153948","89.4","290043","136907","153136","89.4",
"부산광역시","60~64세","2021 년","299182","140499","158683","88.5","297782","139857","157925","88.6",
"부산광역시","60~64세","2022 년","296958","139305","157653","88.4","295549","138660","156889","88.4",
"부산광역시","60~64세","2023 년","293765","137821","155944","88.4","292160","137062","155098","88.4",
"부산광역시","65~69세","2015 년","179266","85208","94058","90.6","178707","84918","93789","90.5",
"부산광역시","65~69세","2016 년","187551","88778","98773","89.9","186987","88491","98496","89.8",
"부산광역시","65~69세","2017 년","195683","92502","103181","89.7","195072","92216","102856","89.7",
"부산광역시","65~69세","2018 년","198815","93440","105375","88.7","198202","93153","105049","88.7",
"부산광역시","65~69세","2019 년","206460","97621","108839","89.7","205671","97240","108431","89.7",
"부산광역시","65~69세","2020 년","224086","105178","118908","88.5","223235","104785","118450","88.5",
"부산광역시","65~69세","2021 년","238468","111574","126894","87.9","237629","111185","126444","87.9",
"부산광역시","65~69세","2022 년","248079","115769","132310","87.5","247161","115346","131815","87.5",
"부산광역시","65~69세","2023 년","260130","121578","138552","87.7","259171","121123","138048","87.7",
"부산광역시","70~74세","2015 년","139102","63744","75358","84.6","138836","63606","75230","84.5",
"부산광역시","70~74세","2016 년","137409","63598","73811","86.2","137198","63487","73711","86.1",
"부산광역시","70~74세","2017 년","140072","64728","75344","85.9","139845","64611","75234","85.9",
"부산광역시","70~74세","2018 년","146932","67877","79055","85.9","146684","67757","78927","85.8",
"부산광역시","70~74세","2019 년","155901","71878","84023","85.5","155589","71710","83879","85.5",
"부산광역시","70~74세","2020 년","164547","75685","88862","85.2","164204","75527","88677","85.2",
"부산광역시","70~74세","2021 년","172378","78884","93494","84.4","172003","78717","93286","84.4",
"부산광역시","70~74세","2022 년","180497","82565","97932","84.3","180074","82376","97698","84.3",
"부산광역시","70~74세","2023 년","184413","83951","100462","83.6","183933","83741","100192","83.6",
"부산광역시","75~79세","2015 년","97349","40105","57244","70.1","97165","40039","57126","70.1",
"부산광역시","75~79세","2016 년","104388","43432","60956","71.3","104222","43369","60853","71.3",
"부산광역시","75~79세","2017 년","113527","48153","65374","73.7","113363","48088","65275","73.7",
"부산광역시","75~79세","2018 년","119267","51114","68153","75","119119","51060","68059","75",
"부산광역시","75~79세","2019 년","121817","52726","69091","76.3","121646","52651","68995","76.3",
"부산광역시","75~79세","2020 년","122339","53377","68962","77.4","122172","53302","68870","77.4",
"부산광역시","75~79세","2021 년","121326","53545","67781","79","121173","53467","67706","79",
"부산광역시","75~79세","2022 년","124096","54767","69329","79","123931","54690","69241","79",
"부산광역시","75~79세","2023 년","130956","57851","73105","79.1","130753","57760","72993","79.1",
"부산광역시","80~84세","2015 년","53120","18065","35055","51.5","53014","18020","34994","51.5",
"부산광역시","80~84세","2016 년","58478","20230","38248","52.9","58373","20189","38184","52.9",
"부산광역시","80~84세","2017 년","62714","22357","40357","55.4","62634","22327","40307","55.4",
"부산광역시","80~84세","2018 년","67136","24403","42733","57.1","67051","24380","42671","57.1",
"부산광역시","80~84세","2019 년","72969","27161","45808","59.3","72872","27123","45749","59.3",
"부산광역시","80~84세","2020 년","77700","29540","48160","61.3","77596","29507","48089","61.4",
"부산광역시","80~84세","2021 년","83456","32240","51216","62.9","83352","32206","51146","63",
"부산광역시","80~84세","2022 년","91218","35794","55424","64.6","91092","35750","55342","64.6",
"부산광역시","80~84세","2023 년","96007","38208","57799","66.1","95872","38157","57715","66.1",
"부산광역시","85~89세","2015 년","23420","5764","17656","32.6","23355","5741","17614","32.6",
"부산광역시","85~89세","2016 년","26094","6581","19513","33.7","26041","6561","19480","33.7",
"부산광역시","85~89세","2017 년","27890","7375","20515","35.9","27851","7359","20492","35.9",
"부산광역시","85~89세","2018 년","29656","8195","21461","38.2","29619","8182","21437","38.2",
"부산광역시","85~89세","2019 년","32198","9177","23021","39.9","32145","9159","22986","39.8",
"부산광역시","85~89세","2020 년","35683","10480","25203","41.6","35648","10473","25175","41.6",
"부산광역시","85~89세","2021 년","38874","11789","27085","43.5","38839","11780","27059","43.5",
"부산광역시","85~89세","2022 년","41440","12971","28469","45.6","41399","12959","28440","45.6",
"부산광역시","85~89세","2023 년","44590","14345","30245","47.4","44541","14331","30210","47.4",
"부산광역시","90~94세","2015 년","7123","1483","5640","26.3","7099","1479","5620","26.3",
"부산광역시","90~94세","2016 년","8080","1588","6492","24.5","8052","1582","6470","24.5",
"부산광역시","90~94세","2017 년","8855","1711","7144","24","8837","1708","7129","24",
"부산광역시","90~94세","2018 년","9707","1898","7809","24.3","9691","1893","7798","24.3",
"부산광역시","90~94세","2019 년","10948","2260","8688","26","10918","2248","8670","25.9",
"부산광역시","90~94세","2020 년","11847","2454","9393","26.1","11834","2448","9386","26.1",
"부산광역시","90~94세","2021 년","12756","2721","10035","27.1","12745","2716","10029","27.1",
"부산광역시","90~94세","2022 년","13434","2996","10438","28.7","13416","2989","10427","28.7",
"부산광역시","90~94세","2023 년","14129","3288","10841","30.3","14106","3278","10828","30.3",
"부산광역시","95~99세","2015 년","1264","229","1035","22.1","1254","223","1031","21.6",
"부산광역시","95~99세","2016 년","1560","274","1286","21.3","1548","268","1280","20.9",
"부산광역시","95~99세","2017 년","1785","331","1454","22.8","1776","327","1449","22.6",
"부산광역시","95~99세","2018 년","2063","375","1688","22.2","2057","372","1685","22.1",
"부산광역시","95~99세","2019 년","2153","382","1771","21.6","2141","378","1763","21.4",
"부산광역시","95~99세","2020 년","2384","404","1980","20.4","2376","401","1975","20.3",
"부산광역시","95~99세","2021 년","2513","421","2092","20.1","2503","419","2084","20.1",
"부산광역시","95~99세","2022 년","2722","407","2315","17.6","2716","406","2310","17.6",
"부산광역시","95~99세","2023 년","3080","470","2610","18","3075","469","2606","18",
"부산광역시","100세이상","2015 년","161","17","144","11.8","156","14","142","9.9",
"부산광역시","100세이상","2016 년","178","15","163","9.2","172","12","160","7.5",
"부산광역시","100세이상","2017 년","208","20","188","10.6","207","19","188","10.1",
"부산광역시","100세이상","2018 년","219","24","195","12.3","219","24","195","12.3",
"부산광역시","100세이상","2019 년","273","41","232","17.7","270","40","230","17.4",
"부산광역시","100세이상","2020 년","304","38","266","14.3","303","37","266","13.9",
"부산광역시","100세이상","2021 년","337","48","289","16.6","335","47","288","16.3",
"부산광역시","100세이상","2022 년","369","64","305","21","367","63","304","20.7",
"부산광역시","100세이상","2023 년","396","58","338","17.2","391","57","334","17.1",
"부산광역시","15세미만","2015 년","403274","208324","194950","106.9","401863","207607","194256","106.9",
"부산광역시","15세미만","2016 년","395647","204000","191647","106.4","394222","203281","190941","106.5",
"부산광역시","15세미만","2017 년","385021","198417","186604","106.3","383979","197912","186067","106.4",
"부산광역시","15세미만","2018 년","374931","192892","182039","106","373629","192243","181386","106",
"부산광역시","15세미만","2019 년","364354","187231","177123","105.7","362710","186454","176256","105.8",
"부산광역시","15세미만","2020 년","356727","183161","173566","105.5","355187","182424","172763","105.6",
"부산광역시","15세미만","2021 년","347277","178205","169072","105.4","345675","177426","168249","105.5",
"부산광역시","15세미만","2022 년","334985","171881","163104","105.4","333259","171038","162221","105.4",
"부산광역시","15세미만","2023 년","322209","165391","156818","105.5","320785","164628","156157","105.4",
"부산광역시","15~64세","2015 년","2544658","1278408","1266250","101","2503218","1253692","1249526","100.3",
"부산광역시","15~64세","2016 년","2521099","1265530","1255569","100.8","2477501","1239866","1237635","100.2",
"부산광역시","15~64세","2017 년","2481163","1245339","1235824","100.8","2434546","1218236","1216310","100.2",
"부산광역시","15~64세","2018 년","2446552","1228766","1217786","100.9","2393501","1198299","1195202","100.3",
"부산광역시","15~64세","2019 년","2405619","1207089","1198530","100.7","2348228","1174542","1173686","100.1",
"부산광역시","15~64세","2020 년","2353399","1178434","1174965","100.3","2301547","1149973","1151574","99.9",
"부산광역시","15~64세","2021 년","2306950","1155318","1151632","100.3","2256747","1128124","1128623","100",
"부산광역시","15~64세","2022 년","2258920","1131733","1127187","100.4","2206372","1103004","1103368","100",
"부산광역시","15~64세","2023 년","2223694","1115141","1108553","100.6","2163921","1081759","1082162","100",
"부산광역시","65세이상","2015 년","500805","214615","286190","75","499586","214040","285546","75",
"부산광역시","65세이상","2016 년","523738","224496","299242","75","522593","223959","298634","75",
"부산광역시","65세이상","2017 년","550734","237177","313557","75.6","549585","236655","312930","75.6",
"부산광역시","65세이상","2018 년","573795","247326","326469","75.8","572642","246821","325821","75.8",
"부산광역시","65세이상","2019 년","602719","261246","341473","76.5","601252","260549","340703","76.5",
"부산광역시","65세이상","2020 년","638890","277156","361734","76.6","637368","276480","360888","76.6",
"부산광역시","65세이상","2021 년","670108","291222","378886","76.9","668579","290537","378042","76.9",
"부산광역시","65세이상","2022 년","701855","305333","396522","77","700156","304579","395577","77",
"부산광역시","65세이상","2023 년","733701","319749","413952","77.2","731842","318916","412926","77.2",
"부산광역시","85세이상","2015 년","31968","7493","24475","30.6","31864","7457","24407","30.6",
"부산광역시","85세이상","2016 년","35912","8458","27454","30.8","35813","8423","27390","30.8",
"부산광역시","85세이상","2017 년","38738","9437","29301","32.2","38671","9413","29258","32.2",
"부산광역시","85세이상","2018 년","41645","10492","31153","33.7","41586","10471","31115","33.7",
"부산광역시","85세이상","2019 년","45572","11860","33712","35.2","45474","11825","33649","35.1",
"부산광역시","85세이상","2020 년","50218","13376","36842","36.3","50161","13359","36802","36.3",
"부산광역시","85세이상","2021 년","54480","14979","39501","37.9","54422","14962","39460","37.9",
"부산광역시","85세이상","2022 년","57965","16438","41527","39.6","57898","16417","41481","39.6",
"부산광역시","85세이상","2023 년","62195","18161","44034","41.2","62113","18135","43978","41.2",
"부산광역시","평균연령","2015 년","42","40.7","43.3","","42.1","40.8","43.4","",
"부산광역시","평균연령","2016 년","42.6","41.2","43.9","","42.7","41.3","44","",
"부산광역시","평균연령","2017 년","43.1","41.7","44.4","","43.2","41.8","44.5","",
"부산광역시","평균연령","2018 년","43.6","42.2","44.9","","43.8","42.4","45.1","",
"부산광역시","평균연령","2019 년","44.2","42.8","45.5","","44.4","43","45.7","",
"부산광역시","평균연령","2020 년","44.8","43.4","46.1","","44.9","43.5","46.2","",
"부산광역시","평균연령","2021 년","45.3","43.9","46.6","","45.5","44.1","46.8","",
"부산광역시","평균연령","2022 년","45.9","44.5","47.2","","46","44.7","47.4","",
"부산광역시","평균연령","2023 년","46.4","45","47.7","","46.6","45.2","47.9","",
"부산광역시","중위연령","2015 년","43.3","41.6","44.9","","43.5","41.8","45","",
"부산광역시","중위연령","2016 년","43.9","42.2","45.5","","44.1","42.5","45.7","",
"부산광역시","중위연령","2017 년","44.5","42.8","46.2","","44.8","43.1","46.4","",
"부산광역시","중위연령","2018 년","45.1","43.4","46.8","","45.5","43.8","47.1","",
"부산광역시","중위연령","2019 년","45.8","44","47.5","","46.2","44.4","47.8","",
"부산광역시","중위연령","2020 년","46.5","44.6","48.2","","46.8","45.1","48.5","",
"부산광역시","중위연령","2021 년","47.1","45.2","48.8","","47.4","45.6","49.1","",
"부산광역시","중위연령","2022 년","47.7","45.8","49.5","","48.1","46.2","49.8","",
"부산광역시","중위연령","2023 년","48.3","46.3","50.1","","48.8","46.8","50.5","",
"대구광역시","합계","2015 년","2466052","1228511","1237541","99.3","2436770","1211219","1225551","98.8",
"대구광역시","합계","2016 년","2461002","1223733","1237269","98.9","2430510","1205785","1224725","98.5",
"대구광역시","합계","2017 년","2453041","1218326","1234715","98.7","2421676","1200214","1221462","98.3",
"대구광역시","합계","2018 년","2444412","1212777","1231635","98.5","2409132","1192938","1216194","98.1",
"대구광역시","합계","2019 년","2429940","1203754","1226186","98.2","2389848","1181573","1208275","97.8",
"대구광역시","합계","2020 년","2410700","1190271","1220429","97.5","2373302","1170625","1202677","97.3",
"대구광역시","합계","2021 년","2387911","1177420","1210491","97.3","2350955","1158350","1192605","97.1",
"대구광역시","합계","2022 년","2366852","1165698","1201154","97","2328003","1145462","1182541","96.9",
"대구광역시","합계","2023 년","2379188","1170854","1208334","96.9","2335997","1147899","1188098","96.6",
"대구광역시","0~4세","2015 년","100686","51635","49051","105.3","100316","51467","48849","105.4",
"대구광역시","0~4세","2016 년","99600","50877","48723","104.4","99198","50692","48506","104.5",
"대구광역시","0~4세","2017 년","94482","48279","46203","104.5","94077","48089","45988","104.6",
"대구광역시","0~4세","2018 년","89739","45833","43906","104.4","89246","45593","43653","104.4",
"대구광역시","0~4세","2019 년","83746","42957","40789","105.3","83044","42613","40431","105.4",
"대구광역시","0~4세","2020 년","75767","38862","36905","105.3","75145","38559","36586","105.4",
"대구광역시","0~4세","2021 년","67629","34732","32897","105.6","67018","34437","32581","105.7",
"대구광역시","0~4세","2022 년","62175","31883","30292","105.3","61546","31566","29980","105.3",
"대구광역시","0~4세","2023 년","58257","29981","28276","106","57630","29654","27976","106",
"대구광역시","5~9세","2015 년","104759","54328","50431","107.7","104465","54182","50283","107.8",
"대구광역시","5~9세","2016 년","105819","54610","51209","106.6","105478","54451","51027","106.7",
"대구광역시","5~9세","2017 년","105630","54539","51091","106.7","105400","54433","50967","106.8",
"대구광역시","5~9세","2018 년","104033","53549","50484","106.1","103736","53404","50332","106.1",
"대구광역시","5~9세","2019 년","103487","53001","50486","105","103047","52798","50249","105.1",
"대구광역시","5~9세","2020 년","102474","52434","50040","104.8","102090","52263","49827","104.9",
"대구광역시","5~9세","2021 년","100372","51280","49092","104.5","99865","51048","48817","104.6",
"대구광역시","5~9세","2022 년","95595","48839","46756","104.5","95036","48586","46450","104.6",
"대구광역시","5~9세","2023 년","91757","46838","44919","104.3","91278","46620","44658","104.4",
"대구광역시","10~14세","2015 년","121266","63988","57278","111.7","121079","63899","57180","111.8",
"대구광역시","10~14세","2016 년","113031","59651","53380","111.7","112807","59533","53274","111.7",
"대구광역시","10~14세","2017 년","110571","57854","52717","109.7","110428","57777","52651","109.7",
"대구광역시","10~14세","2018 년","107821","56116","51705","108.5","107604","56004","51600","108.5",
"대구광역시","10~14세","2019 년","104830","54519","50311","108.4","104538","54381","50157","108.4",
"대구광역시","10~14세","2020 년","104457","54158","50299","107.7","104210","54030","50180","107.7",
"대구광역시","10~14세","2021 년","105005","54244","50761","106.9","104695","54088","50607","106.9",
"대구광역시","10~14세","2022 년","105026","54204","50822","106.7","104684","54040","50644","106.7",
"대구광역시","10~14세","2023 년","104389","53646","50743","105.7","104024","53466","50558","105.8",
"대구광역시","15~19세","2015 년","166041","88179","77862","113.3","165435","87916","77519","113.4",
"대구광역시","15~19세","2016 년","157832","83207","74625","111.5","157226","82907","74319","111.6",
"대구광역시","15~19세","2017 년","147500","77903","69597","111.9","146783","77582","69201","112.1",
"대구광역시","15~19세","2018 년","138818","73362","65456","112.1","137675","72825","64850","112.3",
"대구광역시","15~19세","2019 년","131202","69196","62006","111.6","129326","68252","61074","111.8",
"대구광역시","15~19세","2020 년","120738","63343","57395","110.4","119179","62603","56576","110.7",
"대구광역시","15~19세","2021 년","111424","58469","52955","110.4","110624","58097","52527","110.6",
"대구광역시","15~19세","2022 년","109163","56862","52301","108.7","108169","56379","51790","108.9",
"대구광역시","15~19세","2023 년","107254","55598","51656","107.6","106000","55025","50975","107.9",
"대구광역시","20~24세","2015 년","179886","99182","80704","122.9","175680","96903","78777","123",
"대구광역시","20~24세","2016 년","178227","97665","80562","121.2","174130","95438","78692","121.3",
"대구광역시","20~24세","2017 년","174218","94590","79628","118.8","170185","92441","77744","118.9",
"대구광역시","20~24세","2018 년","171337","92437","78900","117.2","166310","89795","76515","117.4",
"대구광역시","20~24세","2019 년","167561","89812","77749","115.5","161473","86609","74864","115.7",
"대구광역시","20~24세","2020 년","164883","87519","77364","113.1","159127","84584","74543","113.5",
"대구광역시","20~24세","2021 년","158547","83644","74903","111.7","152109","80487","71622","112.4",
"대구광역시","20~24세","2022 년","146632","77965","68667","113.5","139971","74615","65356","114.2",
"대구광역시","20~24세","2023 년","138068","73411","64657","113.5","131101","69849","61252","114",
"대구광역시","25~29세","2015 년","147553","80981","66572","121.6","141245","77207","64038","120.6",
"대구광역시","25~29세","2016 년","149598","82378","67220","122.5","143280","78547","64733","121.3",
"대구광역시","25~29세","2017 년","155003","85155","69848","121.9","148739","81412","67327","120.9",
"대구광역시","25~29세","2018 년","160410","87897","72513","121.2","153809","84028","69781","120.4",
"대구광역시","25~29세","2019 년","161994","88259","73735","119.7","155216","84404","70812","119.2",
"대구광역시","25~29세","2020 년","163122","88145","74977","117.6","156979","84853","72126","117.6",
"대구광역시","25~29세","2021 년","162309","87198","75111","116.1","156459","84177","72282","116.5",
"대구광역시","25~29세","2022 년","157767","83833","73934","113.4","151670","80609","71061","113.4",
"대구광역시","25~29세","2023 년","153687","81427","72260","112.7","146714","77532","69182","112.1",
"대구광역시","30~34세","2015 년","164637","84206","80431","104.7","159794","80998","78796","102.8",
"대구광역시","30~34세","2016 년","155362","80524","74838","107.6","150002","77046","72956","105.6",
"대구광역시","30~34세","2017 년","146261","76811","69450","110.6","140523","73219","67304","108.8",
"대구광역시","30~34세","2018 년","140352","74752","65600","114","133980","70900","63080","112.4",
"대구광역시","30~34세","2019 년","138781","74498","64283","115.9","131908","70502","61406","114.8",
"대구광역시","30~34세","2020 년","138022","74266","63756","116.5","131598","70711","60887","116.1",
"대구광역시","30~34세","2021 년","138675","74734","63941","116.9","132616","71434","61182","116.8",
"대구광역시","30~34세","2022 년","142967","77239","65728","117.5","136847","73852","62995","117.2",
"대구광역시","30~34세","2023 년","148950","80481","68469","117.5","142239","76636","65603","116.8",
"대구광역시","35~39세","2015 년","178427","89710","88717","101.1","175062","87423","87639","99.8",
"대구광역시","35~39세","2016 년","179830","90213","89617","100.7","176247","87870","88377","99.4",
"대구광역시","35~39세","2017 년","180724","90576","90148","100.5","176914","88152","88762","99.3",
"대구광역시","35~39세","2018 년","180401","90566","89835","100.8","175863","87793","88070","99.7",
"대구광역시","35~39세","2019 년","172733","87192","85541","101.9","167704","84174","83530","100.8",
"대구광역시","35~39세","2020 년","160788","81511","79277","102.8","155831","78721","77110","102.1",
"대구광역시","35~39세","2021 년","150689","77251","73438","105.2","145701","74484","71217","104.6",
"대구광역시","35~39세","2022 년","141704","73569","68135","108","136438","70700","65738","107.5",
"대구광역시","35~39세","2023 년","137067","72398","64669","112","131156","69092","62064","111.3",
"대구광역시","40~44세","2015 년","210088","103561","106527","97.2","207504","101876","105628","96.4",
"대구광역시","40~44세","2016 년","199464","98620","100844","97.8","196854","96946","99908","97",
"대구광역시","40~44세","2017 년","191103","94604","96499","98","188438","92955","95483","97.4",
"대구광역시","40~44세","2018 년","181974","90588","91386","99.1","178952","88808","90144","98.5",
"대구광역시","40~44세","2019 년","175876","87458","88418","98.9","172443","85466","86977","98.3",
"대구광역시","40~44세","2020 년","175075","87078","87997","99","171791","85270","86521","98.6",
"대구광역시","40~44세","2021 년","175521","87145","88376","98.6","172142","85319","86823","98.3",
"대구광역시","40~44세","2022 년","176711","87720","88991","98.6","173086","85781","87305","98.3",
"대구광역시","40~44세","2023 년","177772","88276","89496","98.6","173607","86060","87547","98.3",
"대구광역시","45~49세","2015 년","223233","109810","113423","96.8","220992","108561","112431","96.6",
"대구광역시","45~49세","2016 년","225880","110673","115207","96.1","223499","109313","114186","95.7",
"대구광역시","45~49세","2017 년","224449","110254","114195","96.5","221947","108823","113124","96.2",
"대구광역시","45~49세","2018 년","218536","107037","111499","96","215968","105585","110383","95.7",
"대구광역시","45~49세","2019 년","213400","104788","108612","96.5","210465","103132","107333","96.1",
"대구광역시","45~49세","2020 년","204666","100187","104479","95.9","202067","98782","103285","95.6",
"대구광역시","45~49세","2021 년","193349","94993","98356","96.6","190845","93639","97206","96.3",
"대구광역시","45~49세","2022 년","185351","91090","94261","96.6","182788","89708","93080","96.4",
"대구광역시","45~49세","2023 년","178332","88123","90209","97.7","175462","86622","88840","97.5",
"대구광역시","50~54세","2015 년","217525","107366","110159","97.5","215861","106482","109379","97.4",
"대구광역시","50~54세","2016 년","210583","104161","106422","97.9","208701","103182","105519","97.8",
"대구광역시","50~54세","2017 년","208698","102629","106069","96.8","206711","101602","105109","96.7",
"대구광역시","50~54세","2018 년","211168","103557","107611","96.2","209211","102568","106643","96.2",
"대구광역시","50~54세","2019 년","214280","104751","109529","95.6","212064","103547","108517","95.4",
"대구광역시","50~54세","2020 년","214621","104875","109746","95.6","212551","103853","108698","95.5",
"대구광역시","50~54세","2021 년","216592","105452","111140","94.9","214455","104364","110091","94.8",
"대구광역시","50~54세","2022 년","215150","105121","110029","95.5","212849","103916","108933","95.4",
"대구광역시","50~54세","2023 년","212486","103592","108894","95.1","209922","102234","107688","94.9",
"대구광역시","55~59세","2015 년","196256","96598","99658","96.9","195121","96044","99077","96.9",
"대구광역시","55~59세","2016 년","206933","101399","105534","96.1","205773","100831","104942","96.1",
"대구광역시","55~59세","2017 년","211613","103733","107880","96.2","210341","103094","107247","96.1",
"대구광역시","55~59세","2018 년","215213","105143","110070","95.5","213833","104466","109367","95.5",
"대구광역시","55~59세","2019 년","211437","103324","108113","95.6","209875","102566","107309","95.6",
"대구광역시","55~59세","2020 년","206714","100742","105972","95.1","205215","100043","105172","95.1",
"대구광역시","55~59세","2021 년","199334","97690","101644","96.1","197774","96973","100801","96.2",
"대구광역시","55~59세","2022 년","197552","96201","101351","94.9","195902","95414","100488","95",
"대구광역시","55~59세","2023 년","203085","98867","104218","94.9","201216","97961","103255","94.9",
"대구광역시","60~64세","2015 년","143833","68842","74991","91.8","143089","68482","74607","91.8",
"대구광역시","60~64세","2016 년","154574","74135","80439","92.2","153802","73758","80044","92.1",
"대구광역시","60~64세","2017 년","160684","77547","83137","93.3","159839","77126","82713","93.2",
"대구광역시","60~64세","2018 년","166957","81276","85681","94.9","166103","80865","85238","94.9",
"대구광역시","60~64세","2019 년","177148","85958","91190","94.3","176238","85505","90733","94.2",
"대구광역시","60~64세","2020 년","185094","89740","95354","94.1","184181","89330","94851","94.2",
"대구광역시","60~64세","2021 년","194611","94073","100538","93.6","193771","93682","100089","93.6",
"대구광역시","60~64세","2022 년","197979","95477","102502","93.1","197044","95061","101983","93.2",
"대구광역시","60~64세","2023 년","205536","98957","106579","92.8","204340","98415","105925","92.9",
"대구광역시","65~69세","2015 년","105393","49639","55754","89","105074","49482","55592","89",
"대구광역시","65~69세","2016 년","112059","52486","59573","88.1","111690","52302","59388","88.1",
"대구광역시","65~69세","2017 년","118727","55699","63028","88.4","118314","55506","62808","88.4",
"대구광역시","65~69세","2018 년","122153","57029","65124","87.6","121687","56818","64869","87.6",
"대구광역시","65~69세","2019 년","124986","58624","66362","88.3","124465","58390","66075","88.4",
"대구광역시","65~69세","2020 년","135142","63026","72116","87.4","134624","62800","71824","87.4",
"대구광역시","65~69세","2021 년","144646","67678","76968","87.9","144126","67450","76676","88",
"대구광역시","65~69세","2022 년","150321","70781","79540","89","149743","70517","79226","89",
"대구광역시","65~69세","2023 년","159129","75699","83430","90.7","158512","75423","83089","90.8",
"대구광역시","70~74세","2015 년","85165","37358","47807","78.1","84985","37269","47716","78.1",
"대구광역시","70~74세","2016 년","82156","36415","45741","79.6","81996","36343","45653","79.6",
"대구광역시","70~74세","2017 년","82570","36689","45881","80","82415","36611","45804","79.9",
"대구광역시","70~74세","2018 년","86015","38458","47557","80.9","85850","38378","47472","80.8",
"대구광역시","70~74세","2019 년","91533","41253","50280","82","91331","41161","50170","82",
"대구광역시","70~74세","2020 년","97519","44271","53248","83.1","97307","44187","53120","83.2",
"대구광역시","70~74세","2021 년","103563","46847","56716","82.6","103331","46756","56575","82.6",
"대구광역시","70~74세","2022 년","109570","49568","60002","82.6","109295","49461","59834","82.7",
"대구광역시","70~74세","2023 년","115267","52092","63175","82.5","114927","51945","62982","82.5",
"대구광역시","75~79세","2015 년","63484","25269","38215","66.1","63366","25220","38146","66.1",
"대구광역시","75~79세","2016 년","66903","26871","40032","67.1","66802","26831","39971","67.1",
"대구광역시","75~79세","2017 년","72619","29691","42928","69.2","72534","29663","42871","69.2",
"대구광역시","75~79세","2018 년","75948","31409","44539","70.5","75864","31378","44486","70.5",
"대구광역시","75~79세","2019 년","76857","31797","45060","70.6","76747","31752","44995","70.6",
"대구광역시","75~79세","2020 년","75796","31628","44168","71.6","75689","31584","44105","71.6",
"대구광역시","75~79세","2021 년","73247","30990","42257","73.3","73139","30947","42192","73.3",
"대구광역시","75~79세","2022 년","73820","31301","42519","73.6","73696","31252","42444","73.6",
"대구광역시","75~79세","2023 년","79113","33727","45386","74.3","78982","33670","45312","74.3",
"대구광역시","80~84세","2015 년","36977","12722","24255","52.5","36908","12687","24221","52.4",
"대구광역시","80~84세","2016 년","40428","14159","26269","53.9","40347","14121","26226","53.8",
"대구광역시","80~84세","2017 년","42997","15264","27733","55","42934","15238","27696","55",
"대구광역시","80~84세","2018 년","46011","16550","29461","56.2","45955","16532","29423","56.2",
"대구광역시","80~84세","2019 년","49325","18005","31320","57.5","49263","17989","31274","57.5",
"대구광역시","80~84세","2020 년","51639","18941","32698","57.9","51585","18928","32657","58",
"대구광역시","80~84세","2021 년","54585","20287","34298","59.1","54524","20272","34252","59.2",
"대구광역시","80~84세","2022 년","59138","22417","36721","61","59066","22394","36672","61.1",
"대구광역시","80~84세","2023 년","64053","24562","39491","62.2","63972","24536","39436","62.2",
"대구광역시","85~89세","2015 년","15166","3972","11194","35.5","15139","3961","11178","35.4",
"대구광역시","85~89세","2016 년","16689","4432","12257","36.2","16666","4420","12246","36.1",
"대구광역시","85~89세","2017 년","18456","5082","13374","38","18433","5067","13366","37.9",
"대구광역시","85~89세","2018 년","20069","5627","14442","39","20038","5610","14428","38.9",
"대구광역시","85~89세","2019 년","22443","6574","15869","41.4","22403","6551","15852","41.3",
"대구광역시","85~89세","2020 년","25076","7647","17429","43.9","25042","7633","17409","43.8",
"대구광역시","85~89세","2021 년","27677","8609","19068","45.1","27640","8598","19042","45.2",
"대구광역시","85~89세","2022 년","29247","9227","20020","46.1","29206","9216","19990","46.1",
"대구광역시","85~89세","2023 년","32454","10323","22131","46.6","32407","10309","22098","46.7",
"대구광역시","90~94세","2015 년","4684","999","3685","27.1","4671","996","3675","27.1",
"대구광역시","90~94세","2016 년","4942","1074","3868","27.8","4926","1072","3854","27.8",
"대구광역시","90~94세","2017 년","5490","1200","4290","28","5479","1198","4281","28",
"대구광역시","90~94세","2018 년","6096","1333","4763","28","6089","1331","4758","28",
"대구광역시","90~94세","2019 년","6870","1529","5341","28.6","6855","1523","5332","28.6",
"대구광역시","90~94세","2020 년","7468","1602","5866","27.3","7457","1596","5861","27.2",
"대구광역시","90~94세","2021 년","8413","1799","6614","27.2","8404","1794","6610","27.1",
"대구광역시","90~94세","2022 년","9100","2085","7015","29.7","9089","2080","7009","29.7",
"대구광역시","90~94세","2023 년","10365","2491","7874","31.6","10351","2488","7863","31.6",
"대구광역시","95~99세","2015 년","889","155","734","21.1","882","153","729","21",
"대구광역시","95~99세","2016 년","965","170","795","21.4","961","169","792","21.3",
"대구광역시","95~99세","2017 년","1105","206","899","22.9","1102","205","897","22.9",
"대구광역시","95~99세","2018 년","1226","241","985","24.5","1226","241","985","24.5",
"대구광역시","95~99세","2019 년","1301","239","1062","22.5","1297","239","1058","22.6",
"대구광역시","95~99세","2020 년","1454","273","1181","23.1","1453","273","1180","23.1",
"대구광역시","95~99세","2021 년","1509","279","1230","22.7","1507","279","1228","22.7",
"대구광역시","95~99세","2022 년","1647","291","1356","21.5","1644","290","1354","21.4",
"대구광역시","95~99세","2023 년","1931","337","1594","21.1","1925","335","1590","21.1",
"대구광역시","100세이상","2015 년","104","11","93","11.8","102","11","91","12.1",
"대구광역시","100세이상","2016 년","127","13","114","11.4","125","13","112","11.6",
"대구광역시","100세이상","2017 년","141","21","120","17.5","140","21","119","17.6",
"대구광역시","100세이상","2018 년","135","17","118","14.4","133","16","117","13.7",
"대구광역시","100세이상","2019 년","150","20","130","15.4","146","19","127","15",
"대구광역시","100세이상","2020 년","185","23","162","14.2","181","22","159","13.8",
"대구광역시","100세이상","2021 년","214","26","188","13.8","210","25","185","13.5",
"대구광역시","100세이상","2022 년","237","25","212","11.8","234","25","209","12",
"대구광역시","100세이상","2023 년","236","28","208","13.5","232","27","205","13.2",
"대구광역시","15세미만","2015 년","326711","169951","156760","108.4","325860","169548","156312","108.5",
"대구광역시","15세미만","2016 년","318450","165138","153312","107.7","317483","164676","152807","107.8",
"대구광역시","15세미만","2017 년","310683","160672","150011","107.1","309905","160299","149606","107.1",
"대구광역시","15세미만","2018 년","301593","155498","146095","106.4","300586","155001","145585","106.5",
"대구광역시","15세미만","2019 년","292063","150477","141586","106.3","290629","149792","140837","106.4",
"대구광역시","15세미만","2020 년","282698","145454","137244","106","281445","144852","136593","106",
"대구광역시","15세미만","2021 년","273006","140256","132750","105.7","271578","139573","132005","105.7",
"대구광역시","15세미만","2022 년","262796","134926","127870","105.5","261266","134192","127074","105.6",
"대구광역시","15세미만","2023 년","254403","130465","123938","105.3","252932","129740","123192","105.3",
"대구광역시","15~64세","2015 년","1827479","928435","899044","103.3","1799783","911892","887891","102.7",
"대구광역시","15~64세","2016 년","1818283","922975","895308","103.1","1789514","905838","883676","102.5",
"대구광역시","15~64세","2017 년","1800253","913802","886451","103.1","1770420","896406","874014","102.6",
"대구광역시","15~64세","2018 년","1785166","906615","878551","103.2","1751704","887633","864071","102.7",
"대구광역시","15~64세","2019 년","1764412","895236","869176","103","1726712","874157","852555","102.5",
"대구광역시","15~64세","2020 년","1733723","877406","856317","102.5","1698519","858750","839769","102.3",
"대구광역시","15~64세","2021 년","1701051","860649","840402","102.4","1666496","842656","823840","102.3",
"대구광역시","15~64세","2022 년","1670976","845077","825899","102.3","1634764","826035","808729","102.1",
"대구광역시","15~64세","2023 년","1662237","841130","821107","102.4","1621757","819426","802331","102.1",
"대구광역시","65세이상","2015 년","311862","130125","181737","71.6","311127","129779","181348","71.6",
"대구광역시","65세이상","2016 년","324269","135620","188649","71.9","323513","135271","188242","71.9",
"대구광역시","65세이상","2017 년","342105","143852","198253","72.6","341351","143509","197842","72.5",
"대구광역시","65세이상","2018 년","357653","150664","206989","72.8","356842","150304","206538","72.8",
"대구광역시","65세이상","2019 년","373465","158041","215424","73.4","372507","157624","214883","73.4",
"대구광역시","65세이상","2020 년","394279","167411","226868","73.8","393338","167023","226315","73.8",
"대구광역시","65세이상","2021 년","413854","176515","237339","74.4","412881","176121","236760","74.4",
"대구광역시","65세이상","2022 년","433080","185695","247385","75.1","431973","185235","246738","75.1",
"대구광역시","65세이상","2023 년","462548","199259","263289","75.7","461308","198733","262575","75.7",
"대구광역시","85세이상","2015 년","20843","5137","15706","32.7","20794","5121","15673","32.7",
"대구광역시","85세이상","2016 년","22723","5689","17034","33.4","22678","5674","17004","33.4",
"대구광역시","85세이상","2017 년","25192","6509","18683","34.8","25154","6491","18663","34.8",
"대구광역시","85세이상","2018 년","27526","7218","20308","35.5","27486","7198","20288","35.5",
"대구광역시","85세이상","2019 년","30764","8362","22402","37.3","30701","8332","22369","37.2",
"대구광역시","85세이상","2020 년","34183","9545","24638","38.7","34133","9524","24609","38.7",
"대구광역시","85세이상","2021 년","37813","10713","27100","39.5","37761","10696","27065","39.5",
"대구광역시","85세이상","2022 년","40231","11628","28603","40.7","40173","11611","28562","40.7",
"대구광역시","85세이상","2023 년","44986","13179","31807","41.4","44915","13159","31756","41.4",
"대구광역시","평균연령","2015 년","40.5","39.1","41.9","","40.6","39.2","42","",
"대구광역시","평균연령","2016 년","41","39.6","42.4","","41.1","39.7","42.5","",
"대구광역시","평균연령","2017 년","41.6","40.2","43","","41.7","40.3","43","",
"대구광역시","평균연령","2018 년","42.1","40.7","43.5","","42.2","40.8","43.6","",
"대구광역시","평균연령","2019 년","42.7","41.3","44.1","","42.8","41.4","44.2","",
"대구광역시","평균연령","2020 년","43.3","41.9","44.7","","43.4","42","44.8","",
"대구광역시","평균연령","2021 년","43.9","42.5","45.3","","44","42.6","45.4","",
"대구광역시","평균연령","2022 년","44.5","43","45.9","","44.6","43.2","46","",
"대구광역시","평균연령","2023 년","45.2","43.7","46.6","","45.4","43.9","46.8","",
"대구광역시","중위연령","2015 년","41.8","40.1","43.3","","41.9","40.3","43.4","",
"대구광역시","중위연령","2016 년","42.4","40.7","44","","42.6","40.9","44.1","",
"대구광역시","중위연령","2017 년","43.1","41.3","44.6","","43.3","41.6","44.8","",
"대구광역시","중위연령","2018 년","43.7","41.9","45.3","","43.9","42.2","45.5","",
"대구광역시","중위연령","2019 년","44.3","42.5","46","","44.6","42.8","46.2","",
"대구광역시","중위연령","2020 년","45","43.1","46.6","","45.3","43.5","46.9","",
"대구광역시","중위연령","2021 년","45.7","43.8","47.4","","46","44.1","47.7","",
"대구광역시","중위연령","2022 년","46.3","44.4","48.1","","46.7","44.8","48.4","",
"대구광역시","중위연령","2023 년","47.2","45.2","49","","47.5","45.6","49.3","",
"인천광역시","합계","2015 년","2890451","1455017","1435434","101.4","2822601","1414793","1407808","100.5",
"인천광역시","합계","2016 년","2913024","1465699","1447325","101.3","2841151","1423740","1417411","100.4",
"인천광역시","합계","2017 년","2925967","1472081","1453886","101.3","2846797","1426308","1420489","100.4",
"인천광역시","합계","2018 년","2936117","1476097","1460020","101.1","2847628","1425355","1422273","100.2",
"인천광역시","합계","2019 년","2952237","1484528","1467709","101.1","2852063","1427538","1424525","100.2",
"인천광역시","합계","2020 년","2945454","1477064","1468390","100.6","2846242","1422376","1423866","99.9",
"인천광역시","합계","2021 년","2957044","1482202","1474842","100.5","2856665","1427672","1428993","99.9",
"인천광역시","합계","2022 년","2989125","1499105","1490020","100.6","2878924","1438975","1439949","99.9",
"인천광역시","합계","2023 년","3025950","1518154","1507796","100.7","2903900","1450848","1453052","99.8",
"인천광역시","0~4세","2015 년","134744","69261","65483","105.8","133433","68601","64832","105.8",
"인천광역시","0~4세","2016 년","131892","67568","64324","105","130189","66687","63502","105",
"인천광역시","0~4세","2017 년","124268","63515","60753","104.5","122106","62414","59692","104.6",
"인천광역시","0~4세","2018 년","118036","60489","57547","105.1","115194","59017","56177","105.1",
"인천광역시","0~4세","2019 년","111320","57101","54219","105.3","107591","55163","52428","105.2",
"인천광역시","0~4세","2020 년","100431","51612","48819","105.7","96848","49768","47080","105.7",
"인천광역시","0~4세","2021 년","92583","47751","44832","106.5","88956","45827","43129","106.3",
"인천광역시","0~4세","2022 년","88660","45528","43132","105.6","84793","43521","41272","105.4",
"인천광역시","0~4세","2023 년","85809","44041","41768","105.4","82019","42108","39911","105.5",
"인천광역시","5~9세","2015 년","133730","68636","65094","105.4","132833","68167","64666","105.4",
"인천광역시","5~9세","2016 년","136847","70326","66521","105.7","135745","69732","66013","105.6",
"인천광역시","5~9세","2017 년","136093","69818","66275","105.3","134886","69171","65715","105.3",
"인천광역시","5~9세","2018 년","134334","69029","65305","105.7","132732","68203","64529","105.7",
"인천광역시","5~9세","2019 년","133686","68645","65041","105.5","131348","67446","63902","105.5",
"인천광역시","5~9세","2020 년","131940","67711","64229","105.4","129513","66448","63065","105.4",
"인천광역시","5~9세","2021 년","129296","66166","63130","104.8","126047","64535","61512","104.9",
"인천광역시","5~9세","2022 년","124703","63805","60898","104.8","120928","61916","59012","104.9",
"인천광역시","5~9세","2023 년","120175","61580","58595","105.1","116573","59779","56794","105.3",
"인천광역시","10~14세","2015 년","138372","71330","67042","106.4","137756","71021","66735","106.4",
"인천광역시","10~14세","2016 년","132026","68048","63978","106.4","131286","67663","63623","106.3",
"인천광역시","10~14세","2017 년","131586","67772","63814","106.2","130818","67360","63458","106.1",
"인천광역시","10~14세","2018 년","131033","67299","63734","105.6","129962","66761","63201","105.6",
"인천광역시","10~14세","2019 년","130218","66916","63302","105.7","128848","66175","62673","105.6",
"인천광역시","10~14세","2020 년","131690","67621","64069","105.5","130251","66852","63399","105.4",
"인천광역시","10~14세","2021 년","134896","69288","65608","105.6","133098","68336","64762","105.5",
"인천광역시","10~14세","2022 년","135884","69769","66115","105.5","133604","68570","65034","105.4",
"인천광역시","10~14세","2023 년","135954","69782","66172","105.5","133400","68465","64935","105.4",
"인천광역시","15~19세","2015 년","178680","92515","86165","107.4","177427","91926","85501","107.5",
"인천광역시","15~19세","2016 년","172119","88867","83252","106.7","170796","88238","82558","106.9",
"인천광역시","15~19세","2017 년","162955","84290","78665","107.2","161436","83538","77898","107.2",
"인천광역시","15~19세","2018 년","154377","79492","74885","106.2","152415","78508","73907","106.2",
"인천광역시","15~19세","2019 년","148004","76109","71895","105.9","144931","74614","70317","106.1",
"인천광역시","15~19세","2020 년","137257","70521","66736","105.7","135404","69640","65764","105.9",
"인천광역시","15~19세","2021 년","131154","67406","63748","105.7","129497","66640","62857","106",
"인천광역시","15~19세","2022 년","132701","68236","64465","105.8","130153","66954","63199","105.9",
"인천광역시","15~19세","2023 년","132676","68199","64477","105.8","129524","66522","63002","105.6",
"인천광역시","20~24세","2015 년","201475","106897","94578","113","195760","103630","92130","112.5",
"인천광역시","20~24세","2016 년","200319","106207","94112","112.9","194664","103050","91614","112.5",
"인천광역시","20~24세","2017 년","197084","104667","92417","113.3","190964","101150","89814","112.6",
"인천광역시","20~24세","2018 년","191027","100888","90139","111.9","183634","96524","87110","110.8",
"인천광역시","20~24세","2019 년","187191","98715","88476","111.6","178713","93696","85017","110.2",
"인천광역시","20~24세","2020 년","183896","95592","88304","108.3","176352","91324","85028","107.4",
"인천광역시","20~24세","2021 년","175046","91028","84018","108.3","168369","87551","80818","108.3",
"인천광역시","20~24세","2022 년","166160","87029","79131","110","158558","82916","75642","109.6",
"인천광역시","20~24세","2023 년","157298","82599","74699","110.6","148494","77579","70915","109.4",
"인천광역시","25~29세","2015 년","191414","99680","91734","108.7","180149","92437","87712","105.4",
"인천광역시","25~29세","2016 년","196261","102669","93592","109.7","184813","95397","89416","106.7",
"인천광역시","25~29세","2017 년","204316","107177","97139","110.3","192289","99678","92611","107.6",
"인천광역시","25~29세","2018 년","211776","111540","100236","111.3","199068","103655","95413","108.6",
"인천광역시","25~29세","2019 년","217524","115323","102201","112.8","204276","107152","97124","110.3",
"인천광역시","25~29세","2020 년","218574","115347","103227","111.7","206715","108376","98339","110.2",
"인천광역시","25~29세","2021 년","217238","114544","102694","111.5","206383","108188","98195","110.2",
"인천광역시","25~29세","2022 년","214799","113241","101558","111.5","203164","106274","96890","109.7",
"인천광역시","25~29세","2023 년","210265","110638","99627","111.1","197336","102727","94609","108.6",
"인천광역시","30~34세","2015 년","226657","118283","108374","109.1","215364","110647","104717","105.7",
"인천광역시","30~34세","2016 년","215786","112731","103055","109.4","203756","104770","98986","105.8",
"인천광역시","30~34세","2017 년","204842","107338","97504","110.1","191132","98538","92594","106.4",
"인천광역시","30~34세","2018 년","197752","103992","93760","110.9","182629","94429","88200","107.1",
"인천광역시","30~34세","2019 년","195774","103261","92513","111.6","179654","93239","86415","107.9",
"인천광역시","30~34세","2020 년","194775","102684","92091","111.5","178600","93053","85547","108.8",
"인천광역시","30~34세","2021 년","200102","105470","94632","111.5","184385","96308","88077","109.3",
"인천광역시","30~34세","2022 년","212250","112307","99943","112.4","196346","102929","93417","110.2",
"인천광역시","30~34세","2023 년","223469","118812","104657","113.5","206667","108633","98034","110.8",
"인천광역시","35~39세","2015 년","233734","121355","112379","108","225552","115824","109728","105.6",
"인천광역시","35~39세","2016 년","241311","125265","116046","107.9","232443","119436","113007","105.7",
"인천광역시","35~39세","2017 년","245608","127772","117836","108.4","235463","121144","114319","106",
"인천광역시","35~39세","2018 년","246585","128284","118301","108.4","235177","120955","114222","105.9",
"인천광역시","35~39세","2019 년","239555","124551","115004","108.3","226943","116706","110237","105.9",
"인천광역시","35~39세","2020 년","225743","117514","108229","108.6","212499","109421","103078","106.2",
"인천광역시","35~39세","2021 년","216944","113101","103843","108.9","202693","104569","98124","106.6",
"인천광역시","35~39세","2022 년","210038","109700","100338","109.3","194322","100320","94002","106.7",
"인천광역시","35~39세","2023 년","208503","109528","98975","110.7","190817","98970","91847","107.8",
"인천광역시","40~44세","2015 년","252877","129684","123193","105.3","246248","125550","120698","104",
"인천광역시","40~44세","2016 년","243144","125017","118127","105.8","236486","120922","115564","104.6",
"인천광역시","40~44세","2017 년","236594","121708","114886","105.9","229666","117476","112190","104.7",
"인천광역시","40~44세","2018 년","229935","118706","111229","106.7","222363","114071","108292","105.3",
"인천광역시","40~44세","2019 년","228183","117893","110290","106.9","219597","112671","106926","105.4",
"인천광역시","40~44세","2020 년","230990","119057","111933","106.4","221969","113714","108255","105",
"인천광역시","40~44세","2021 년","238433","123174","115259","106.9","228872","117553","111319","105.6",
"인천광역시","40~44세","2022 년","246425","127633","118792","107.4","235633","121323","114310","106.1",
"인천광역시","40~44세","2023 년","253034","131451","121583","108.1","240509","124101","116408","106.6",
"인천광역시","45~49세","2015 년","257583","128105","129478","98.9","251664","124803","126861","98.4",
"인천광역시","45~49세","2016 년","262988","130951","132037","99.2","256690","127454","129236","98.6",
"인천광역시","45~49세","2017 년","264819","132593","132226","100.3","257927","128857","129070","99.8",
"인천광역시","45~49세","2018 년","261999","131828","130171","101.3","254782","127906","126876","100.8",
"인천광역시","45~49세","2019 년","258677","131290","127387","103.1","250778","126838","123940","102.3",
"인천광역시","45~49세","2020 년","251386","127783","123603","103.4","243799","123607","120192","102.8",
"인천광역시","45~49세","2021 년","241442","123109","118333","104","234008","118961","115047","103.4",
"인천광역시","45~49세","2022 년","237223","121130","116093","104.3","229483","116825","112658","103.7",
"인천광역시","45~49세","2023 년","233181","119618","113563","105.3","224658","114851","109807","104.6",
"인천광역시","50~54세","2015 년","259355","130922","128433","101.9","254071","128241","125830","101.9",
"인천광역시","50~54세","2016 년","252565","127011","125554","101.2","246810","124088","122722","101.1",
"인천광역시","50~54세","2017 년","248976","124334","124642","99.8","242952","121264","121688","99.7",
"인천광역시","50~54세","2018 년","250929","124114","126815","97.9","244686","120985","123701","97.8",
"인천광역시","50~54세","2019 년","256421","126446","129975","97.3","249493","122841","126652","97",
"인천광역시","50~54세","2020 년","255672","126290","129382","97.6","248733","122760","125973","97.4",
"인천광역시","50~54세","2021 년","260690","128983","131707","97.9","253484","125262","128222","97.7",
"인천광역시","50~54세","2022 년","264359","131642","132717","99.2","256451","127513","128938","98.9",
"인천광역시","50~54세","2023 년","264244","132158","132086","100.1","255672","127706","127966","99.8",
"인천광역시","55~59세","2015 년","228142","115321","112821","102.2","224191","113415","110776","102.4",
"인천광역시","55~59세","2016 년","244514","123563","120951","102.2","240439","121586","118853","102.3",
"인천광역시","55~59세","2017 년","253235","127747","125488","101.8","248726","125516","123210","101.9",
"인천광역시","55~59세","2018 년","258924","130359","128565","101.4","253606","127802","125804","101.6",
"인천광역시","55~59세","2019 년","258996","130128","128868","101","252658","127081","125577","101.2",
"인천광역시","55~59세","2020 년","255044","127389","127655","99.8","248403","124238","124165","100.1",
"인천광역시","55~59세","2021 년","248673","123871","124802","99.3","241665","120542","121123","99.5",
"인천광역시","55~59세","2022 년","246507","122032","124475","98","239261","118529","120732","98.2",
"인천광역시","55~59세","2023 년","250604","122993","127611","96.4","242906","119287","123619","96.5",
"인천광역시","60~64세","2015 년","145648","72459","73189","99","142642","71024","71618","99.2",
"인천광역시","60~64세","2016 년","163424","81238","82186","98.8","160142","79697","80445","99.1",
"인천광역시","60~64세","2017 년","175988","87511","88477","98.9","172207","85743","86464","99.2",
"인천광역시","60~64세","2018 년","192973","96094","96879","99.2","188689","94087","94602","99.5",
"인천광역시","60~64세","2019 년","208358","103782","104576","99.2","203564","101489","102075","99.4",
"인천광역시","60~64세","2020 년","222461","110882","111579","99.4","217086","108336","108750","99.6",
"인천광역시","60~64세","2021 년","238398","118726","119672","99.2","233044","116221","116823","99.5",
"인천광역시","60~64세","2022 년","247820","123143","124677","98.8","241961","120470","121491","99.2",
"인천광역시","60~64세","2023 년","255466","126793","128673","98.5","248679","123692","124987","99",
"인천광역시","65~69세","2015 년","105831","51662","54169","95.4","104562","51086","53476","95.5",
"인천광역시","65~69세","2016 년","107994","52804","55190","95.7","106421","52077","54344","95.8",
"인천광역시","65~69세","2017 년","114342","56188","58154","96.6","112431","55316","57115","96.9",
"인천광역시","65~69세","2018 년","118397","57999","60398","96","116217","56989","59228","96.2",
"인천광역시","65~69세","2019 년","126286","61745","64541","95.7","123622","60539","63083","96",
"인천광역시","65~69세","2020 년","141056","68629","72427","94.8","137888","67219","70669","95.1",
"인천광역시","65~69세","2021 년","157992","76701","81291","94.4","154620","75221","79399","94.7",
"인천광역시","65~69세","2022 년","170691","82877","87814","94.4","166595","81052","85543","94.8",
"인천광역시","65~69세","2023 년","188357","91580","96777","94.6","183663","89484","94179","95",
"인천광역시","70~74세","2015 년","81169","36863","44306","83.2","80618","36632","43986","83.3",
"인천광역시","70~74세","2016 년","82453","37771","44682","84.5","81859","37543","44316","84.7",
"인천광역시","70~74세","2017 년","85084","39244","45840","85.6","84419","38986","45433","85.8",
"인천광역시","70~74세","2018 년","89707","41983","47724","88","88949","41691","47258","88.2",
"인천광역시","70~74세","2019 년","95646","45011","50635","88.9","94641","44589","50052","89.1",
"인천광역시","70~74세","2020 년","101005","47817","53188","89.9","99792","47322","52470","90.2",
"인천광역시","70~74세","2021 년","102795","48735","54060","90.1","101380","48137","53243","90.4",
"인천광역시","70~74세","2022 년","109209","52042","57167","91","107390","51273","56117","91.4",
"인천광역시","70~74세","2023 년","113898","54112","59786","90.5","111689","53201","58488","91",
"인천광역시","75~79세","2015 년","59991","23966","36025","66.5","59617","23816","35801","66.5",
"인천광역시","75~79세","2016 년","63104","25641","37463","68.4","62698","25487","37211","68.5",
"인천광역시","75~79세","2017 년","69168","28614","40554","70.6","68744","28466","40278","70.7",
"인천광역시","75~79세","2018 년","71759","30051","41708","72.1","71359","29917","41442","72.2",
"인천광역시","75~79세","2019 년","73266","31179","42087","74.1","72779","31011","41768","74.2",
"인천광역시","75~79세","2020 년","74691","32119","42572","75.4","74106","31931","42175","75.7",
"인천광역시","75~79세","2021 년","75904","33025","42879","77","75326","32849","42477","77.3",
"인천광역시","75~79세","2022 년","78583","34642","43941","78.8","77875","34418","43457","79.2",
"인천광역시","75~79세","2023 년","83296","37194","46102","80.7","82437","36901","45536","81",
"인천광역시","80~84세","2015 년","36032","11836","24196","48.9","35832","11778","24054","49",
"인천광역시","80~84세","2016 년","39532","13348","26184","51","39320","13288","26032","51",
"인천광역시","80~84세","2017 년","41984","14539","27445","53","41734","14475","27259","53.1",
"인천광역시","80~84세","2018 년","45096","16003","29093","55","44825","15935","28890","55.2",
"인천광역시","80~84세","2019 년","48528","17580","30948","56.8","48205","17486","30719","56.9",
"인천광역시","80~84세","2020 년","50540","18501","32039","57.7","50165","18408","31757","58",
"인천광역시","80~84세","2021 년","53575","20022","33553","59.7","53180","19915","33265","59.9",
"인천광역시","80~84세","2022 년","58882","22340","36542","61.1","58419","22222","36197","61.4",
"인천광역시","80~84세","2023 년","61576","23743","37833","62.8","61054","23599","37455","63",
"인천광역시","85~89세","2015 년","17449","4438","13011","34.1","17364","4411","12953","34.1",
"인천광역시","85~89세","2016 년","18710","4848","13862","35","18610","4820","13790","35",
"인천광역시","85~89세","2017 년","20262","5320","14942","35.6","20163","5294","14869","35.6",
"인천광역시","85~89세","2018 년","21839","5837","16002","36.5","21736","5820","15916","36.6",
"인천광역시","85~89세","2019 년","23659","6469","17190","37.6","23534","6443","17091","37.7",
"인천광역시","85~89세","2020 년","26186","7500","18686","40.1","26048","7474","18574","40.2",
"인천광역시","85~89세","2021 년","28804","8432","20372","41.4","28638","8398","20240","41.5",
"인천광역시","85~89세","2022 년","30306","9143","21163","43.2","30129","9099","21030","43.3",
"인천광역시","85~89세","2023 년","32903","10159","22744","44.7","32642","10085","22557","44.7",
"인천광역시","90~94세","2015 년","6099","1478","4621","32","6065","1466","4599","31.9",
"인천광역시","90~94세","2016 년","6398","1466","4932","29.7","6363","1455","4908","29.6",
"인천광역시","90~94세","2017 년","6951","1536","5415","28.4","6931","1531","5400","28.4",
"인천광역시","90~94세","2018 년","7571","1640","5931","27.7","7542","1634","5908","27.7",
"인천광역시","90~94세","2019 년","8679","1889","6790","27.8","8638","1876","6762","27.7",
"인천광역시","90~94세","2020 년","9644","2024","7620","26.6","9604","2016","7588","26.6",
"인천광역시","90~94세","2021 년","10402","2194","8208","26.7","10354","2186","8168","26.8",
"인천광역시","90~94세","2022 년","11047","2339","8708","26.9","10994","2328","8666","26.9",
"인천광역시","90~94세","2023 년","12049","2627","9422","27.9","11979","2613","9366","27.9",
"인천광역시","95~99세","2015 년","1314","299","1015","29.5","1300","292","1008","29",
"인천광역시","95~99세","2016 년","1456","325","1131","28.7","1442","317","1125","28.2",
"인천광역시","95~99세","2017 년","1607","363","1244","29.2","1600","358","1242","28.8",
"인천광역시","95~99세","2018 년","1849","441","1408","31.3","1845","438","1407","31.1",
"인천광역시","95~99세","2019 년","1993","441","1552","28.4","1981","433","1548","28",
"인천광역시","95~99세","2020 년","2184","426","1758","24.2","2179","425","1754","24.2",
"인천광역시","95~99세","2021 년","2300","407","1893","21.5","2290","405","1885","21.5",
"인천광역시","95~99세","2022 년","2485","454","2031","22.4","2476","454","2022","22.5",
"인천광역시","95~99세","2023 년","2735","455","2280","20","2726","455","2271","20",
"인천광역시","100세이상","2015 년","155","27","128","21.1","153","26","127","20.5",
"인천광역시","100세이상","2016 년","181","35","146","24","179","33","146","22.6",
"인천광역시","100세이상","2017 년","205","35","170","20.6","203","33","170","19.4",
"인천광역시","100세이상","2018 년","219","29","190","15.3","218","28","190","14.7",
"인천광역시","100세이상","2019 년","273","54","219","24.7","269","50","219","22.8",
"인천광역시","100세이상","2020 년","289","45","244","18.4","288","44","244","18",
"인천광역시","100세이상","2021 년","377","69","308","22.4","376","68","308","22.1",
"인천광역시","100세이상","2022 년","393","73","320","22.8","389","69","320","21.6",
"인천광역시","100세이상","2023 년","458","92","366","25.1","456","90","366","24.6",
"인천광역시","15세미만","2015 년","406846","209227","197619","105.9","404022","207789","196233","105.9",
"인천광역시","15세미만","2016 년","400765","205942","194823","105.7","397220","204082","193138","105.7",
"인천광역시","15세미만","2017 년","391947","201105","190842","105.4","387810","198945","188865","105.3",
"인천광역시","15세미만","2018 년","383403","196817","186586","105.5","377888","193981","183907","105.5",
"인천광역시","15세미만","2019 년","375224","192662","182562","105.5","367787","188784","179003","105.5",
"인천광역시","15세미만","2020 년","364061","186944","177117","105.5","356612","183068","173544","105.5",
"인천광역시","15세미만","2021 년","356775","183205","173570","105.6","348101","178698","169403","105.5",
"인천광역시","15세미만","2022 년","349247","179102","170145","105.3","339325","174007","165318","105.3",
"인천광역시","15세미만","2023 년","341938","175403","166535","105.3","331992","170352","161640","105.4",
"인천광역시","15~64세","2015 년","2175565","1115221","1060344","105.2","2113068","1077497","1035571","104",
"인천광역시","15~64세","2016 년","2192431","1123519","1068912","105.1","2127039","1084638","1042401","104.1",
"인천광역시","15~64세","2017 년","2194417","1125137","1069280","105.2","2122762","1082904","1039858","104.1",
"인천광역시","15~64세","2018 년","2196277","1125297","1070980","105.1","2117049","1078922","1038127","103.9",
"인천광역시","15~64세","2019 년","2198683","1127498","1071185","105.3","2110607","1076327","1034280","104.1",
"인천광역시","15~64세","2020 년","2175798","1113059","1062739","104.7","2089560","1064469","1025091","103.8",
"인천광역시","15~64세","2021 년","2168120","1109412","1058708","104.8","2082400","1061795","1020605","104",
"인천광역시","15~64세","2022 년","2178282","1116093","1062189","105.1","2085332","1064053","1021279","104.2",
"인천광역시","15~64세","2023 년","2188740","1122789","1065951","105.3","2085262","1064068","1021194","104.2",
"인천광역시","65세이상","2015 년","308040","130569","177471","73.6","305511","129507","176004","73.6",
"인천광역시","65세이상","2016 년","319828","136238","183590","74.2","316892","135020","181872","74.2",
"인천광역시","65세이상","2017 년","339603","145839","193764","75.3","336225","144459","191766","75.3",
"인천광역시","65세이상","2018 년","356437","153983","202454","76.1","352691","152452","200239","76.1",
"인천광역시","65세이상","2019 년","378330","164368","213962","76.8","373669","162427","211242","76.9",
"인천광역시","65세이상","2020 년","405595","177061","228534","77.5","400070","174839","225231","77.6",
"인천광역시","65세이상","2021 년","432149","189585","242564","78.2","426164","187179","238985","78.3",
"인천광역시","65세이상","2022 년","461596","203910","257686","79.1","454267","200915","253352","79.3",
"인천광역시","65세이상","2023 년","495272","219962","275310","79.9","486646","216428","270218","80.1",
"인천광역시","85세이상","2015 년","25017","6242","18775","33.2","24882","6195","18687","33.2",
"인천광역시","85세이상","2016 년","26745","6674","20071","33.3","26594","6625","19969","33.2",
"인천광역시","85세이상","2017 년","29025","7254","21771","33.3","28897","7216","21681","33.3",
"인천광역시","85세이상","2018 년","31478","7947","23531","33.8","31341","7920","23421","33.8",
"인천광역시","85세이상","2019 년","34604","8853","25751","34.4","34422","8802","25620","34.4",
"인천광역시","85세이상","2020 년","38303","9995","28308","35.3","38119","9959","28160","35.4",
"인천광역시","85세이상","2021 년","41883","11102","30781","36.1","41658","11057","30601","36.1",
"인천광역시","85세이상","2022 년","44231","12009","32222","37.3","43988","11950","32038","37.3",
"인천광역시","85세이상","2023 년","48145","13333","34812","38.3","47803","13243","34560","38.3",
"인천광역시","평균연령","2015 년","39.4","38.4","40.3","","39.4","38.4","40.3","",
"인천광역시","평균연령","2016 년","39.9","38.9","40.8","","39.9","39","40.9","",
"인천광역시","평균연령","2017 년","40.4","39.4","41.4","","40.5","39.5","41.4","",
"인천광역시","평균연령","2018 년","41","40","42","","41.1","40.1","42","",
"인천광역시","평균연령","2019 년","41.5","40.5","42.5","","41.7","40.7","42.7","",
"인천광역시","평균연령","2020 년","42.2","41.1","43.2","","42.3","41.3","43.3","",
"인천광역시","평균연령","2021 년","42.7","41.7","43.8","","42.9","41.9","43.9","",
"인천광역시","평균연령","2022 년","43.2","42.2","44.3","","43.4","42.4","44.4","",
"인천광역시","평균연령","2023 년","43.8","42.7","44.8","","44","42.9","45","",
"인천광역시","중위연령","2015 년","40.1","39.1","41.2","","40.3","39.3","41.2","",
"인천광역시","중위연령","2016 년","40.7","39.6","41.8","","40.9","39.9","41.9","",
"인천광역시","중위연령","2017 년","41.3","40.2","42.4","","41.5","40.5","42.6","",
"인천광역시","중위연령","2018 년","41.9","40.7","43.1","","42.2","41.1","43.3","",
"인천광역시","중위연령","2019 년","42.4","41.3","43.7","","42.8","41.7","44","",
"인천광역시","중위연령","2020 년","43.1","42","44.4","","43.5","42.4","44.6","",
"인천광역시","중위연령","2021 년","43.7","42.6","45","","44.1","42.9","45.3","",
"인천광역시","중위연령","2022 년","44.2","43","45.5","","44.6","43.4","45.8","",
"인천광역시","중위연령","2023 년","44.7","43.6","46.1","","45.2","44","46.4","",
"광주광역시","합계","2015 년","1502881","748867","754014","99.3","1481289","736656","744633","98.9",
"광주광역시","합계","2016 년","1501557","747303","754254","99.1","1477856","734092","743764","98.7",
"광주광역시","합계","2017 년","1496172","745122","751050","99.2","1470120","730590","739530","98.8",
"광주광역시","합계","2018 년","1490092","741728","748364","99.1","1460259","725127","735132","98.6",
"광주광역시","합계","2019 년","1489730","741287","748443","99","1456444","722939","733505","98.6",
"광주광역시","합계","2020 년","1477573","734140","743433","98.7","1447000","717832","729168","98.4",
"광주광역시","합계","2021 년","1475262","732088","743174","98.5","1444765","716048","728717","98.3",
"광주광역시","합계","2022 년","1468972","728859","740113","98.5","1436109","711350","724759","98.1",
"광주광역시","합계","2023 년","1457090","722226","734864","98.3","1421816","703206","718610","97.9",
"광주광역시","0~4세","2015 년","68224","35204","33020","106.6","67938","35062","32876","106.6",
"광주광역시","0~4세","2016 년","66628","34232","32396","105.7","66264","34048","32216","105.7",
"광주광역시","0~4세","2017 년","62390","32071","30319","105.8","61966","31851","30115","105.8",
"광주광역시","0~4세","2018 년","59117","30351","28766","105.5","58606","30092","28514","105.5",
"광주광역시","0~4세","2019 년","55212","28386","26826","105.8","54510","28041","26469","105.9",
"광주광역시","0~4세","2020 년","50161","25580","24581","104.1","49582","25287","24295","104.1",
"광주광역시","0~4세","2021 년","46442","23732","22710","104.5","45778","23397","22381","104.5",
"광주광역시","0~4세","2022 년","43614","22279","21335","104.4","42878","21888","20990","104.3",
"광주광역시","0~4세","2023 년","39999","20350","19649","103.6","39290","19977","19313","103.4",
"광주광역시","5~9세","2015 년","74575","38605","35970","107.3","74367","38495","35872","107.3",
"광주광역시","5~9세","2016 년","74728","38669","36059","107.2","74465","38540","35925","107.3",
"광주광역시","5~9세","2017 년","73720","38125","35595","107.1","73463","37996","35467","107.1",
"광주광역시","5~9세","2018 년","72461","37429","35032","106.8","72122","37270","34852","106.9",
"광주광역시","5~9세","2019 년","71975","37069","34906","106.2","71430","36809","34621","106.3",
"광주광역시","5~9세","2020 년","70839","36580","34259","106.8","70353","36342","34011","106.9",
"광주광역시","5~9세","2021 년","68675","35314","33361","105.9","68009","34994","33015","106",
"광주광역시","5~9세","2022 년","64848","33370","31478","106","64098","33005","31093","106.1",
"광주광역시","5~9세","2023 년","61242","31464","29778","105.7","60570","31109","29461","105.6",
"광주광역시","10~14세","2015 년","83894","43636","40258","108.4","83751","43563","40188","108.4",
"광주광역시","10~14세","2016 년","78398","40840","37558","108.7","78207","40741","37466","108.7",
"광주광역시","10~14세","2017 년","76924","40081","36843","108.8","76739","39989","36750","108.8",
"광주광역시","10~14세","2018 년","74979","38907","36072","107.9","74735","38783","35952","107.9",
"광주광역시","10~14세","2019 년","73432","38032","35400","107.4","73128","37887","35241","107.5",
"광주광역시","10~14세","2020 년","73754","38149","35605","107.1","73441","38004","35437","107.2",
"광주광역시","10~14세","2021 년","74192","38334","35858","106.9","73837","38152","35685","106.9",
"광주광역시","10~14세","2022 년","73620","38048","35572","107","73142","37814","35328","107",
"광주광역시","10~14세","2023 년","72416","37366","35050","106.6","71883","37104","34779","106.7",
"광주광역시","15~19세","2015 년","113385","58626","54759","107.1","112826","58342","54484","107.1",
"광주광역시","15~19세","2016 년","108159","55626","52533","105.9","107517","55309","52208","105.9",
"광주광역시","15~19세","2017 년","101974","52426","49548","105.8","101208","52003","49205","105.7",
"광주광역시","15~19세","2018 년","95991","49482","46509","106.4","94765","48861","45904","106.4",
"광주광역시","15~19세","2019 년","90702","46731","43971","106.3","89293","46023","43270","106.4",
"광주광역시","15~19세","2020 년","81777","42398","39379","107.7","80887","41996","38891","108",
"광주광역시","15~19세","2021 년","77867","40062","37805","106","77168","39729","37439","106.1",
"광주광역시","15~19세","2022 년","76904","39589","37315","106.1","75943","39121","36822","106.2",
"광주광역시","15~19세","2023 년","75170","38683","36487","106","73877","38017","35860","106",
"광주광역시","20~24세","2015 년","118234","60865","57369","106.1","114226","58861","55365","106.3",
"광주광역시","20~24세","2016 년","119181","61847","57334","107.9","114951","59666","55285","107.9",
"광주광역시","20~24세","2017 년","119367","62113","57254","108.5","114650","59629","55021","108.4",
"광주광역시","20~24세","2018 년","118636","61702","56934","108.4","113013","58534","54479","107.4",
"광주광역시","20~24세","2019 년","117694","60731","56963","106.6","111384","57139","54245","105.3",
"광주광역시","20~24세","2020 년","113852","59055","54797","107.8","108360","55942","52418","106.7",
"광주광역시","20~24세","2021 년","111615","57114","54501","104.8","106097","54180","51917","104.4",
"광주광역시","20~24세","2022 년","105779","54043","51736","104.5","100201","51042","49159","103.8",
"광주광역시","20~24세","2023 년","99376","51267","48109","106.6","93074","47838","45236","105.8",
"광주광역시","25~29세","2015 년","94121","48775","45346","107.6","89544","46054","43490","105.9",
"광주광역시","25~29세","2016 년","93810","48861","44949","108.7","88844","45932","42912","107",
"광주광역시","25~29세","2017 년","97045","50937","46108","110.5","91856","47859","43997","108.8",
"광주광역시","25~29세","2018 년","100269","52939","47330","111.9","94546","49599","44947","110.3",
"광주광역시","25~29세","2019 년","104600","55536","49064","113.2","98608","52051","46557","111.8",
"광주광역시","25~29세","2020 년","106966","56242","50724","110.9","101494","53190","48304","110.1",
"광주광역시","25~29세","2021 년","108975","57475","51500","111.6","103700","54528","49172","110.9",
"광주광역시","25~29세","2022 년","108556","57332","51224","111.9","102787","53999","48788","110.7",
"광주광역시","25~29세","2023 년","106455","56182","50273","111.8","100403","52609","47794","110.1",
"광주광역시","30~34세","2015 년","110306","56574","53732","105.3","107109","54517","52592","103.7",
"광주광역시","30~34세","2016 년","103257","53030","50227","105.6","99729","50888","48841","104.2",
"광주광역시","30~34세","2017 년","95426","49153","46273","106.2","91459","46800","44659","104.8",
"광주광역시","30~34세","2018 년","89671","46229","43442","106.4","85190","43611","41579","104.9",
"광주광역시","30~34세","2019 년","87174","45097","42077","107.2","82165","42265","39900","105.9",
"광주광역시","30~34세","2020 년","86109","44639","41470","107.6","81265","41949","39316","106.7",
"광주광역시","30~34세","2021 년","87425","45429","41996","108.2","82747","42844","39903","107.4",
"광주광역시","30~34세","2022 년","90878","47394","43484","109","86080","44712","41368","108.1",
"광주광역시","30~34세","2023 년","93658","49213","44445","110.7","88623","46322","42301","109.5",
"광주광역시","35~39세","2015 년","117812","59316","58496","101.4","115620","57898","57722","100.3",
"광주광역시","35~39세","2016 년","117658","58976","58682","100.5","115222","57448","57774","99.4",
"광주광역시","35~39세","2017 년","118159","59325","58834","100.8","115375","57623","57752","99.8",
"광주광역시","35~39세","2018 년","117599","59291","58308","101.7","114352","57367","56985","100.7",
"광주광역시","35~39세","2019 년","113361","57516","55845","103","109729","55438","54291","102.1",
"광주광역시","35~39세","2020 년","106220","54072","52148","103.7","102632","52109","50523","103.1",
"광주광역시","35~39세","2021 년","100313","51200","49113","104.2","96670","49213","47457","103.7",
"광주광역시","35~39세","2022 년","93391","47642","45749","104.1","89444","45493","43951","103.5",
"광주광역시","35~39세","2023 년","87663","44786","42877","104.5","83471","42510","40961","103.8",
"광주광역시","40~44세","2015 년","132138","66368","65770","100.9","130315","65265","65050","100.3",
"광주광역시","40~44세","2016 년","126485","63576","62909","101.1","124493","62410","62083","100.5",
"광주광역시","40~44세","2017 년","122387","61443","60944","100.8","120315","60271","60044","100.4",
"광주광역시","40~44세","2018 년","117521","59064","58457","101","115139","57737","57402","100.6",
"광주광역시","40~44세","2019 년","114858","57481","57377","100.2","112199","55999","56200","99.6",
"광주광역시","40~44세","2020 년","115100","57375","57725","99.4","112603","56016","56587","99",
"광주광역시","40~44세","2021 년","115496","57517","57979","99.2","112977","56169","56808","98.9",
"광주광역시","40~44세","2022 년","116704","58287","58417","99.8","113870","56761","57109","99.4",
"광주광역시","40~44세","2023 년","116220","58221","57999","100.4","113288","56653","56635","100",
"광주광역시","45~49세","2015 년","131046","65889","65157","101.1","129578","65091","64487","100.9",
"광주광역시","45~49세","2016 년","134150","67154","66996","100.2","132463","66241","66222","100",
"광주광역시","45~49세","2017 년","135394","67815","67579","100.3","133468","66749","66719","100",
"광주광역시","45~49세","2018 년","133365","66705","66660","100.1","131257","65535","65722","99.7",
"광주광역시","45~49세","2019 년","133073","66538","66535","100","130788","65303","65485","99.7",
"광주광역시","45~49세","2020 년","128960","64319","64641","99.5","126826","63237","63589","99.4",
"광주광역시","45~49세","2021 년","123506","61806","61700","100.2","121442","60772","60670","100.2",
"광주광역시","45~49세","2022 년","119662","59786","59876","99.8","117589","58721","58868","99.8",
"광주광역시","45~49세","2023 년","115092","57504","57588","99.9","112903","56384","56519","99.8",
"광주광역시","50~54세","2015 년","117496","59081","58415","101.1","116176","58467","57709","101.3",
"광주광역시","50~54세","2016 년","117447","59303","58144","102","116006","58621","57385","102.2",
"광주광역시","50~54세","2017 년","118620","59695","58925","101.3","117057","58950","58107","101.5",
"광주광역시","50~54세","2018 년","121016","60588","60428","100.3","119357","59776","59581","100.3",
"광주광역시","50~54세","2019 년","124598","62354","62244","100.2","122797","61422","61375","100.1",
"광주광역시","50~54세","2020 년","126078","63089","62989","100.2","124416","62290","62126","100.3",
"광주광역시","50~54세","2021 년","128776","64241","64535","99.5","127076","63402","63674","99.6",
"광주광역시","50~54세","2022 년","130377","65123","65254","99.8","128511","64189","64322","99.8",
"광주광역시","50~54세","2023 년","128969","64168","64801","99","127012","63189","63823","99",
"광주광역시","55~59세","2015 년","104589","51584","53005","97.3","103710","51147","52563","97.3",
"광주광역시","55~59세","2016 년","111120","54780","56340","97.2","110190","54325","55865","97.2",
"광주광역시","55~59세","2017 년","112903","55781","57122","97.7","111863","55259","56604","97.6",
"광주광역시","55~59세","2018 년","115081","57147","57934","98.6","113988","56624","57364","98.7",
"광주광역시","55~59세","2019 년","114111","56861","57250","99.3","112832","56240","56592","99.4",
"광주광역시","55~59세","2020 년","111673","55684","55989","99.5","110423","55115","55308","99.7",
"광주광역시","55~59세","2021 년","111082","55676","55406","100.5","109813","55111","54702","100.7",
"광주광역시","55~59세","2022 년","112303","56153","56150","100","110947","55539","55408","100.2",
"광주광역시","55~59세","2023 년","115134","57206","57928","98.8","113710","56548","57162","98.9",
"광주광역시","60~64세","2015 년","70853","34236","36617","93.5","70364","33990","36374","93.4",
"광주광역시","60~64세","2016 년","75538","36728","38810","94.6","74989","36450","38539","94.6",
"광주광역시","60~64세","2017 년","79969","38949","41020","95","79317","38624","40693","94.9",
"광주광역시","60~64세","2018 년","85764","41772","43992","95","85074","41426","43648","94.9",
"광주광역시","60~64세","2019 년","92620","45158","47462","95.1","91893","44794","47099","95.1",
"광주광역시","60~64세","2020 년","98575","48116","50459","95.4","97836","47765","50071","95.4",
"광주광역시","60~64세","2021 년","104581","50920","53661","94.9","103831","50563","53268","94.9",
"광주광역시","60~64세","2022 년","106112","51641","54471","94.8","105263","51239","54024","94.8",
"광주광역시","60~64세","2023 년","108366","52825","55541","95.1","107381","52371","55010","95.2",
"광주광역시","65~69세","2015 년","57375","27276","30099","90.6","57162","27172","29990","90.6",
"광주광역시","65~69세","2016 년","59291","28020","31271","89.6","59030","27903","31127","89.6",
"광주광역시","65~69세","2017 년","60530","28669","31861","90","60235","28534","31701","90",
"광주광역시","65~69세","2018 년","60852","28732","32120","89.5","60567","28609","31958","89.5",
"광주광역시","65~69세","2019 년","61784","29249","32535","89.9","61437","29100","32337","90",
"광주광역시","65~69세","2020 년","66517","31439","35078","89.6","66157","31285","34872","89.7",
"광주광역시","65~69세","2021 년","70586","33561","37025","90.6","70186","33390","36796","90.7",
"광주광역시","65~69세","2022 년","74812","35640","39172","91","74327","35430","38897","91.1",
"광주광역시","65~69세","2023 년","80537","38312","42225","90.7","80001","38066","41935","90.8",
"광주광역시","70~74세","2015 년","45099","20395","24704","82.6","45007","20356","24651","82.6",
"광주광역시","70~74세","2016 년","45355","20774","24581","84.5","45256","20733","24523","84.5",
"광주광역시","70~74세","2017 년","45550","20888","24662","84.7","45436","20841","24595","84.7",
"광주광역시","70~74세","2018 년","47800","21911","25889","84.6","47683","21862","25821","84.7",
"광주광역시","70~74세","2019 년","51048","23388","27660","84.6","50895","23316","27579","84.5",
"광주광역시","70~74세","2020 년","53351","24490","28861","84.9","53206","24435","28771","84.9",
"광주광역시","70~74세","2021 년","55041","25109","29932","83.9","54880","25056","29824","84",
"광주광역시","70~74세","2022 년","56268","25736","30532","84.3","56053","25659","30394","84.4",
"광주광역시","70~74세","2023 년","56792","25836","30956","83.5","56538","25741","30797","83.6",
"광주광역시","75~79세","2015 년","32151","13011","19140","68","32077","12975","19102","67.9",
"광주광역시","75~79세","2016 년","34776","14244","20532","69.4","34711","14215","20496","69.4",
"광주광역시","75~79세","2017 년","38509","16167","22342","72.4","38448","16141","22307","72.4",
"광주광역시","75~79세","2018 년","39582","16788","22794","73.7","39528","16768","22760","73.7",
"광주광역시","75~79세","2019 년","39989","17076","22913","74.5","39917","17051","22866","74.6",
"광주광역시","75~79세","2020 년","40661","17529","23132","75.8","40590","17503","23087","75.8",
"광주광역시","75~79세","2021 년","40725","17838","22887","77.9","40654","17813","22841","78",
"광주광역시","75~79세","2022 년","41048","17970","23078","77.9","40955","17939","23016","77.9",
"광주광역시","75~79세","2023 년","43395","18926","24469","77.3","43283","18886","24397","77.4",
"광주광역시","80~84세","2015 년","18914","6399","12515","51.1","18874","6381","12493","51.1",
"광주광역시","80~84세","2016 년","21087","7177","13910","51.6","21054","7162","13892","51.6",
"광주광역시","80~84세","2017 년","22271","7798","14473","53.9","22247","7791","14456","53.9",
"광주광역시","80~84세","2018 년","24092","8630","15462","55.8","24057","8618","15439","55.8",
"광주광역시","80~84세","2019 년","25592","9477","16115","58.8","25559","9466","16093","58.8",
"광주광역시","80~84세","2020 년","27124","10132","16992","59.6","27090","10121","16969","59.6",
"광주광역시","80~84세","2021 년","28908","11017","17891","61.6","28869","11002","17867","61.6",
"광주광역시","80~84세","2022 년","31976","12552","19424","64.6","31929","12536","19393","64.6",
"광주광역시","80~84세","2023 년","32742","12997","19745","65.8","32683","12975","19708","65.8",
"광주광역시","85~89세","2015 년","9032","2345","6687","35.1","9019","2341","6678","35.1",
"광주광역시","85~89세","2016 년","10251","2660","7591","35","10238","2656","7582","35",
"광주광역시","85~89세","2017 년","10576","2841","7735","36.7","10565","2835","7730","36.7",
"광주광역시","85~89세","2018 년","11432","3127","8305","37.7","11420","3121","8299","37.6",
"광주광역시","85~89세","2019 년","12598","3509","9089","38.6","12582","3501","9081","38.6",
"광주광역시","85~89세","2020 년","13701","4008","9693","41.3","13690","4004","9686","41.3",
"광주광역시","85~89세","2021 년","14613","4394","10219","43","14594","4386","10208","43",
"광주광역시","85~89세","2022 년","15433","4849","10584","45.8","15416","4844","10572","45.8",
"광주광역시","85~89세","2023 년","16660","5375","11285","47.6","16633","5367","11266","47.6",
"광주광역시","90~94세","2015 년","2941","586","2355","24.9","2934","584","2350","24.9",
"광주광역시","90~94세","2016 년","3411","704","2707","26","3404","703","2701","26",
"광주광역시","90~94세","2017 년","3562","728","2834","25.7","3558","728","2830","25.7",
"광주광역시","90~94세","2018 년","3783","778","3005","25.9","3780","778","3002","25.9",
"광주광역시","90~94세","2019 년","4267","947","3320","28.5","4258","944","3314","28.5",
"광주광역시","90~94세","2020 년","4988","1078","3910","27.6","4983","1076","3907","27.5",
"광주광역시","90~94세","2021 년","5215","1169","4046","28.9","5210","1167","4043","28.9",
"광주광역시","90~94세","2022 년","5444","1241","4203","29.5","5435","1235","4200","29.4",
"광주광역시","90~94세","2023 년","5816","1331","4485","29.7","5807","1326","4481","29.6",
"광주광역시","95~99세","2015 년","610","93","517","18","606","92","514","17.9",
"광주광역시","95~99세","2016 년","734","96","638","15","730","95","635","15",
"광주광역시","95~99세","2017 년","804","109","695","15.7","803","109","694","15.7",
"광주광역시","95~99세","2018 년","978","148","830","17.8","977","148","829","17.9",
"광주광역시","95~99세","2019 년","917","141","776","18.2","915","140","775","18.1",
"광주광역시","95~99세","2020 년","1027","156","871","17.9","1026","156","870","17.9",
"광주광역시","95~99세","2021 년","1064","164","900","18.2","1062","164","898","18.3",
"광주광역시","95~99세","2022 년","1081","168","913","18.4","1079","168","911","18.4",
"광주광역시","95~99세","2023 년","1180","199","981","20.3","1179","199","980","20.3",
"광주광역시","100세이상","2015 년","86","X","83","3.6","86","X","83","3.6",
"광주광역시","100세이상","2016 년","93","6","87","6.9","93","6","87","6.9",
"광주광역시","100세이상","2017 년","92","8","84","9.5","92","8","84","9.5",
"광주광역시","100세이상","2018 년","103","8","95","8.4","103","8","95","8.4",
"광주광역시","100세이상","2019 년","125","10","115","8.7","125","10","115","8.7",
"광주광역시","100세이상","2020 년","140","10","130","7.7","140","10","130","7.7",
"광주광역시","100세이상","2021 년","165","16","149","10.7","165","16","149","10.7",
"광주광역시","100세이상","2022 년","162","16","146","11","162","16","146","11",
"광주광역시","100세이상","2023 년","208","15","193","7.8","207","15","192","7.8",
"광주광역시","15세미만","2015 년","226693","117445","109248","107.5","226056","117120","108936","107.5",
"광주광역시","15세미만","2016 년","219754","113741","106013","107.3","218936","113329","105607","107.3",
"광주광역시","15세미만","2017 년","213034","110277","102757","107.3","212168","109836","102332","107.3",
"광주광역시","15세미만","2018 년","206557","106687","99870","106.8","205463","106145","99318","106.9",
"광주광역시","15세미만","2019 년","200619","103487","97132","106.5","199068","102737","96331","106.6",
"광주광역시","15세미만","2020 년","194754","100309","94445","106.2","193376","99633","93743","106.3",
"광주광역시","15세미만","2021 년","189309","97380","91929","105.9","187624","96543","91081","106",
"광주광역시","15세미만","2022 년","182082","93697","88385","106","180118","92707","87411","106.1",
"광주광역시","15세미만","2023 년","173657","89180","84477","105.6","171743","88190","83553","105.5",
"광주광역시","15~64세","2015 년","1109980","561314","548666","102.3","1089468","549632","539836","101.8",
"광주광역시","15~64세","2016 년","1106805","559881","546924","102.4","1084404","547290","537114","101.9",
"광주광역시","15~64세","2017 년","1101244","557637","543607","102.6","1076568","543767","532801","102.1",
"광주광역시","15~64세","2018 년","1094913","554919","539994","102.8","1066681","539070","527611","102.2",
"광주광역시","15~64세","2019 년","1092791","554003","538788","102.8","1061688","536674","525014","102.2",
"광주광역시","15~64세","2020 년","1075310","544989","530321","102.8","1046742","529609","517133","102.4",
"광주광역시","15~64세","2021 년","1069636","541440","528196","102.5","1041521","526511","515010","102.2",
"광주광역시","15~64세","2022 년","1060666","536990","523676","102.5","1030635","520816","509819","102.2",
"광주광역시","15~64세","2023 년","1046103","530055","516048","102.7","1013742","512441","501301","102.2",
"광주광역시","65세이상","2015 년","166208","70108","96100","73","165765","69904","95861","72.9",
"광주광역시","65세이상","2016 년","174998","73681","101317","72.7","174516","73473","101043","72.7",
"광주광역시","65세이상","2017 년","181894","77208","104686","73.8","181384","76987","104397","73.7",
"광주광역시","65세이상","2018 년","188622","80122","108500","73.8","188115","79912","108203","73.9",
"광주광역시","65세이상","2019 년","196320","83797","112523","74.5","195688","83528","112160","74.5",
"광주광역시","65세이상","2020 년","207509","88842","118667","74.9","206882","88590","118292","74.9",
"광주광역시","65세이상","2021 년","216317","93268","123049","75.8","215620","92994","122626","75.8",
"광주광역시","65세이상","2022 년","226224","98172","128052","76.7","225356","97827","127529","76.7",
"광주광역시","65세이상","2023 년","237330","102991","134339","76.7","236331","102575","133756","76.7",
"광주광역시","85세이상","2015 년","12669","3027","9642","31.4","12645","3020","9625","31.4",
"광주광역시","85세이상","2016 년","14489","3466","11023","31.4","14465","3460","11005","31.4",
"광주광역시","85세이상","2017 년","15034","3686","11348","32.5","15018","3680","11338","32.5",
"광주광역시","85세이상","2018 년","16296","4061","12235","33.2","16280","4055","12225","33.2",
"광주광역시","85세이상","2019 년","17907","4607","13300","34.6","17880","4595","13285","34.6",
"광주광역시","85세이상","2020 년","19856","5252","14604","36","19839","5246","14593","35.9",
"광주광역시","85세이상","2021 년","21057","5743","15314","37.5","21031","5733","15298","37.5",
"광주광역시","85세이상","2022 년","22120","6274","15846","39.6","22092","6263","15829","39.6",
"광주광역시","85세이상","2023 년","23864","6920","16944","40.8","23826","6907","16919","40.8",
"광주광역시","평균연령","2015 년","38.4","37.4","39.5","","38.5","37.4","39.5","",
"광주광역시","평균연령","2016 년","39.1","38","40.2","","39.1","38","40.2","",
"광주광역시","평균연령","2017 년","39.6","38.5","40.7","","39.7","38.6","40.8","",
"광주광역시","평균연령","2018 년","40.1","39","41.2","","40.2","39.1","41.4","",
"광주광역시","평균연령","2019 년","40.7","39.5","41.8","","40.8","39.7","41.9","",
"광주광역시","평균연령","2020 년","41.3","40.2","42.4","","41.4","40.3","42.6","",
"광주광역시","평균연령","2021 년","41.8","40.7","42.9","","42","40.8","43.1","",
"광주광역시","평균연령","2022 년","42.3","41.2","43.4","","42.5","41.4","43.6","",
"광주광역시","평균연령","2023 년","42.9","41.8","44.1","","43.2","42","44.3","",
"광주광역시","중위연령","2015 년","38.7","37.7","39.8","","38.9","37.9","40","",
"광주광역시","중위연령","2016 년","39.5","38.4","40.6","","39.7","38.6","40.8","",
"광주광역시","중위연령","2017 년","40.1","38.9","41.3","","40.4","39.2","41.5","",
"광주광역시","중위연령","2018 년","40.7","39.5","41.9","","41.1","39.9","42.2","",
"광주광역시","중위연령","2019 년","41.3","40.1","42.5","","41.7","40.5","42.9","",
"광주광역시","중위연령","2020 년","42.1","40.9","43.3","","42.4","41.2","43.6","",
"광주광역시","중위연령","2021 년","42.6","41.5","43.8","","43","41.8","44.2","",
"광주광역시","중위연령","2022 년","43.2","42.1","44.4","","43.6","42.5","44.8","",
"광주광역시","중위연령","2023 년","44","42.7","45.3","","44.4","43.2","45.7","",
"대전광역시","합계","2015 년","1538394","772243","766151","100.8","1519314","763310","756004","101",
"대전광역시","합계","2016 년","1535445","770971","764474","100.8","1515758","761749","754009","101",
"대전광역시","합계","2017 년","1525849","765718","760131","100.7","1505315","756015","749300","100.9",
"대전광역시","합계","2018 년","1511214","758035","753179","100.6","1488356","747076","741280","100.8",
"대전광역시","합계","2019 년","1498839","751585","747254","100.6","1473692","739521","734171","100.7",
"대전광역시","합계","2020 년","1488435","744349","744086","100","1465507","733852","731655","100.3",
"대전광역시","합계","2021 년","1479740","740481","739259","100.2","1456477","730007","726470","100.5",
"대전광역시","합계","2022 년","1473662","737127","736535","100.1","1447379","725095","722284","100.4",
"대전광역시","합계","2023 년","1470336","735804","734532","100.2","1440902","722241","718661","100.5",
"대전광역시","0~4세","2015 년","71002","36522","34480","105.9","70595","36317","34278","105.9",
"대전광역시","0~4세","2016 년","68623","35442","33181","106.8","68220","35246","32974","106.9",
"대전광역시","0~4세","2017 년","64234","33069","31165","106.1","63859","32879","30980","106.1",
"대전광역시","0~4세","2018 년","59396","30594","28802","106.2","58893","30335","28558","106.2",
"대전광역시","0~4세","2019 년","54516","28033","26483","105.9","53878","27703","26175","105.8",
"대전광역시","0~4세","2020 년","48875","25091","23784","105.5","48318","24791","23527","105.4",
"대전광역시","0~4세","2021 년","44193","22674","21519","105.4","43686","22417","21269","105.4",
"대전광역시","0~4세","2022 년","42027","21562","20465","105.4","41557","21318","20239","105.3",
"대전광역시","0~4세","2023 년","40077","20595","19482","105.7","39678","20409","19269","105.9",
"대전광역시","5~9세","2015 년","73099","37564","35535","105.7","72834","37432","35402","105.7",
"대전광역시","5~9세","2016 년","72785","37439","35346","105.9","72474","37283","35191","105.9",
"대전광역시","5~9세","2017 년","70900","36547","34353","106.4","70702","36443","34259","106.4",
"대전광역시","5~9세","2018 년","68890","35427","33463","105.9","68636","35299","33337","105.9",
"대전광역시","5~9세","2019 년","67447","34651","32796","105.7","67086","34473","32613","105.7",
"대전광역시","5~9세","2020 년","66365","34063","32302","105.5","66020","33891","32129","105.5",
"대전광역시","5~9세","2021 년","63674","32806","30868","106.3","63229","32582","30647","106.3",
"대전광역시","5~9세","2022 년","60376","31006","29370","105.6","59923","30771","29152","105.6",
"대전광역시","5~9세","2023 년","56335","29009","27326","106.2","56015","28848","27167","106.2",
"대전광역시","10~14세","2015 년","79517","41381","38136","108.5","79326","41279","38047","108.5",
"대전광역시","10~14세","2016 년","74600","38839","35761","108.6","74416","38749","35667","108.6",
"대전광역시","10~14세","2017 년","72938","37702","35236","107","72834","37650","35184","107",
"대전광역시","10~14세","2018 년","71056","36792","34264","107.4","70916","36718","34198","107.4",
"대전광역시","10~14세","2019 년","68743","35528","33215","107","68532","35414","33118","106.9",
"대전광역시","10~14세","2020 년","68533","35265","33268","106","68353","35174","33179","106",
"대전광역시","10~14세","2021 년","68619","35266","33353","105.7","68418","35173","33245","105.8",
"대전광역시","10~14세","2022 년","67274","34753","32521","106.9","67066","34656","32410","106.9",
"대전광역시","10~14세","2023 년","66159","34109","32050","106.4","65956","34008","31948","106.4",
"대전광역시","15~19세","2015 년","111778","58503","53275","109.8","110851","58039","52812","109.9",
"대전광역시","15~19세","2016 년","107174","56028","51146","109.5","106199","55551","50648","109.7",
"대전광역시","15~19세","2017 년","100929","53119","47810","111.1","99918","52627","47291","111.3",
"대전광역시","15~19세","2018 년","95355","49889","45466","109.7","94176","49284","44892","109.8",
"대전광역시","15~19세","2019 년","90628","47490","43138","110.1","89180","46773","42407","110.3",
"대전광역시","15~19세","2020 년","83574","43616","39958","109.2","82649","43201","39448","109.5",
"대전광역시","15~19세","2021 년","78502","41386","37116","111.5","77543","40942","36601","111.9",
"대전광역시","15~19세","2022 년","78421","41074","37347","110","76595","40241","36354","110.7",
"대전광역시","15~19세","2023 년","76680","40074","36606","109.5","74874","39275","35599","110.3",
"대전광역시","20~24세","2015 년","129333","69006","60327","114.4","124959","67259","57700","116.6",
"대전광역시","20~24세","2016 년","130171","69372","60799","114.1","125729","67541","58188","116.1",
"대전광역시","20~24세","2017 년","129500","68272","61228","111.5","124742","66189","58553","113",
"대전광역시","20~24세","2018 년","127118","67257","59861","112.4","121799","64753","57046","113.5",
"대전광역시","20~24세","2019 년","124362","65124","59238","109.9","118844","62522","56322","111",
"대전광역시","20~24세","2020 년","123236","63832","59404","107.5","118916","61742","57174","108",
"대전광역시","20~24세","2021 년","120355","62073","58282","106.5","115568","59832","55736","107.3",
"대전광역시","20~24세","2022 년","114288","59231","55057","107.6","108284","56324","51960","108.4",
"대전광역시","20~24세","2023 년","110397","57650","52747","109.3","103006","54068","48938","110.5",
"대전광역시","25~29세","2015 년","102960","55473","47487","116.8","99506","53931","45575","118.3",
"대전광역시","25~29세","2016 년","104574","56827","47747","119","101112","55241","45871","120.4",
"대전광역시","25~29세","2017 년","107541","58575","48966","119.6","104070","57006","47064","121.1",
"대전광역시","25~29세","2018 년","109138","59465","49673","119.7","105447","57750","47697","121.1",
"대전광역시","25~29세","2019 년","111165","60580","50585","119.8","107362","58810","48552","121.1",
"대전광역시","25~29세","2020 년","113202","61378","51824","118.4","109481","59724","49757","120",
"대전광역시","25~29세","2021 년","114451","62133","52318","118.8","110698","60457","50241","120.3",
"대전광역시","25~29세","2022 년","114309","61872","52437","118","110202","59969","50233","119.4",
"대전광역시","25~29세","2023 년","113406","61115","52291","116.9","108881","58935","49946","118",
"대전광역시","30~34세","2015 년","111896","57146","54750","104.4","109626","56022","53604","104.5",
"대전광역시","30~34세","2016 년","106200","54786","51414","106.6","103764","53602","50162","106.9",
"대전광역시","30~34세","2017 년","99955","51950","48005","108.2","97389","50697","46692","108.6",
"대전광역시","30~34세","2018 년","95251","49924","45327","110.1","92226","48479","43747","110.8",
"대전광역시","30~34세","2019 년","92983","49344","43639","113.1","89567","47691","41876","113.9",
"대전광역시","30~34세","2020 년","92626","49509","43117","114.8","89214","47935","41279","116.1",
"대전광역시","30~34세","2021 년","93871","50231","43640","115.1","90640","48766","41874","116.5",
"대전광역시","30~34세","2022 년","97278","51959","45319","114.7","93926","50445","43481","116",
"대전광역시","30~34세","2023 년","100474","53663","46811","114.6","96885","52047","44838","116.1",
"대전광역시","35~39세","2015 년","117076","58510","58566","99.9","115499","57676","57823","99.7",
"대전광역시","35~39세","2016 년","117611","58980","58631","100.6","115923","58097","57826","100.5",
"대전광역시","35~39세","2017 년","117258","58975","58283","101.2","115339","58000","57339","101.2",
"대전광역시","35~39세","2018 년","115195","58223","56972","102.2","112989","57163","55826","102.4",
"대전광역시","35~39세","2019 년","110133","55973","54160","103.3","107673","54797","52876","103.6",
"대전광역시","35~39세","2020 년","103463","52723","50740","103.9","101066","51661","49405","104.6",
"대전광역시","35~39세","2021 년","97511","50060","47451","105.5","95114","49027","46087","106.4",
"대전광역시","35~39세","2022 년","92298","47723","44575","107.1","89837","46627","43210","107.9",
"대전광역시","35~39세","2023 년","89369","46538","42831","108.7","86500","45259","41241","109.7",
"대전광역시","40~44세","2015 년","131185","65652","65533","100.2","129832","64917","64915","100",
"대전광역시","40~44세","2016 년","124435","62183","62252","99.9","123095","61480","61615","99.8",
"대전광역시","40~44세","2017 년","119963","59653","60310","98.9","118619","58968","59651","98.9",
"대전광역시","40~44세","2018 년","114245","56910","57335","99.3","112684","56119","56565","99.2",
"대전광역시","40~44세","2019 년","110297","54900","55397","99.1","108499","54028","54471","99.2",
"대전광역시","40~44세","2020 년","109803","54504","55299","98.6","108048","53719","54329","98.9",
"대전광역시","40~44세","2021 년","110452","55051","55401","99.4","108709","54282","54427","99.7",
"대전광역시","40~44세","2022 년","110342","55124","55218","99.8","108470","54313","54157","100.3",
"대전광역시","40~44세","2023 년","109939","55170","54769","100.7","107748","54219","53529","101.3",
"대전광역시","45~49세","2015 년","132439","66027","66412","99.4","131233","65417","65816","99.4",
"대전광역시","45~49세","2016 년","136168","67626","68542","98.7","134867","66973","67894","98.6",
"대전광역시","45~49세","2017 년","135868","67710","68158","99.3","134391","66964","67427","99.3",
"대전광역시","45~49세","2018 년","132763","66216","66547","99.5","131208","65439","65769","99.5",
"대전광역시","45~49세","2019 년","129472","64766","64706","100.1","127794","63914","63880","100.1",
"대전광역시","45~49세","2020 년","125131","62357","62774","99.3","123677","61703","61974","99.6",
"대전광역시","45~49세","2021 년","118451","58917","59534","99","117052","58301","58751","99.2",
"대전광역시","45~49세","2022 년","114827","56843","57984","98","113408","56219","57189","98.3",
"대전광역시","45~49세","2023 년","110096","54553","55543","98.2","108511","53874","54637","98.6",
"대전광역시","50~54세","2015 년","124062","62074","61988","100.1","122940","61561","61379","100.3",
"대전광역시","50~54세","2016 년","118332","59524","58808","101.2","117174","58988","58186","101.4",
"대전광역시","50~54세","2017 년","116530","58423","58107","100.5","115320","57849","57471","100.7",
"대전광역시","50~54세","2018 년","119473","59413","60060","98.9","118247","58815","59432","99",
"대전광역시","50~54세","2019 년","123737","61470","62267","98.7","122395","60798","61597","98.7",
"대전광역시","50~54세","2020 년","124672","62086","62586","99.2","123339","61482","61857","99.4",
"대전광역시","50~54세","2021 년","128354","63875","64479","99.1","127049","63294","63755","99.3",
"대전광역시","50~54세","2022 년","128748","64212","64536","99.5","127359","63584","63775","99.7",
"대전광역시","50~54세","2023 년","127073","63442","63631","99.7","125530","62726","62804","99.9",
"대전광역시","55~59세","2015 년","112837","56067","56770","98.8","111972","55657","56315","98.8",
"대전광역시","55~59세","2016 년","119005","58831","60174","97.8","118164","58451","59713","97.9",
"대전광역시","55~59세","2017 년","120940","59704","61236","97.5","120051","59304","60747","97.6",
"대전광역시","55~59세","2018 년","120602","59583","61019","97.6","119675","59156","60519","97.7",
"대전광역시","55~59세","2019 년","118422","58710","59712","98.3","117361","58220","59141","98.4",
"대전광역시","55~59세","2020 년","115148","57176","57972","98.6","114107","56731","57376","98.9",
"대전광역시","55~59세","2021 년","109814","54891","54923","99.9","108750","54442","54308","100.2",
"대전광역시","55~59세","2022 년","108680","54172","54508","99.4","107593","53703","53890","99.7",
"대전광역시","55~59세","2023 년","112814","55956","56858","98.4","111616","55427","56189","98.6",
"대전광역시","60~64세","2015 년","76905","37934","38971","97.3","76359","37665","38694","97.3",
"대전광역시","60~64세","2016 년","84594","41679","42915","97.1","83973","41361","42612","97.1",
"대전광역시","60~64세","2017 년","89692","44318","45374","97.7","89008","43969","45039","97.6",
"대전광역시","60~64세","2018 년","95516","47003","48513","96.9","94799","46667","48132","97",
"대전광역시","60~64세","2019 년","100048","49170","50878","96.6","99335","48832","50503","96.7",
"대전광역시","60~64세","2020 년","104664","51199","53465","95.8","103939","50871","53068","95.9",
"대전광역시","60~64세","2021 년","110624","53963","56661","95.2","109919","53662","56257","95.4",
"대전광역시","60~64세","2022 년","112458","54746","57712","94.9","111711","54437","57274","95",
"대전광역시","60~64세","2023 년","113102","55250","57852","95.5","112217","54858","57359","95.6",
"대전광역시","65~69세","2015 년","55685","27093","28592","94.8","55427","26976","28451","94.8",
"대전광역시","65~69세","2016 년","57734","28014","29720","94.3","57464","27901","29563","94.4",
"대전광역시","65~69세","2017 년","60862","29617","31245","94.8","60569","29491","31078","94.9",
"대전광역시","65~69세","2018 년","62122","30195","31927","94.6","61807","30050","31757","94.6",
"대전광역시","65~69세","2019 년","65580","31696","33884","93.5","65191","31528","33663","93.7",
"대전광역시","65~69세","2020 년","71436","34483","36953","93.3","71000","34293","36707","93.4",
"대전광역시","65~69세","2021 년","78382","37797","40585","93.1","77964","37606","40358","93.2",
"대전광역시","65~69세","2022 년","83129","40151","42978","93.4","82648","39940","42708","93.5",
"대전광역시","65~69세","2023 년","88814","42876","45938","93.3","88337","42658","45679","93.4",
"대전광역시","70~74세","2015 년","43903","19937","23966","83.2","43789","19876","23913","83.1",
"대전광역시","70~74세","2016 년","43843","20176","23667","85.2","43738","20129","23609","85.3",
"대전광역시","70~74세","2017 년","43445","20060","23385","85.8","43332","20004","23328","85.8",
"대전광역시","70~74세","2018 년","45609","21292","24317","87.6","45486","21243","24243","87.6",
"대전광역시","70~74세","2019 년","48045","22645","25400","89.2","47872","22570","25302","89.2",
"대전광역시","70~74세","2020 년","51259","24107","27152","88.8","51076","24034","27042","88.9",
"대전광역시","70~74세","2021 년","53165","24976","28189","88.6","52965","24898","28067","88.7",
"대전광역시","70~74세","2022 년","56239","26531","29708","89.3","56018","26450","29568","89.5",
"대전광역시","70~74세","2023 년","57813","27322","30491","89.6","57562","27226","30336","89.7",
"대전광역시","75~79세","2015 년","32246","13226","19020","69.5","32163","13189","18974","69.5",
"대전광역시","75~79세","2016 년","33817","14061","19756","71.2","33729","14023","19706","71.2",
"대전광역시","75~79세","2017 년","37257","15793","21464","73.6","37190","15767","21423","73.6",
"대전광역시","75~79세","2018 년","38310","16295","22015","74","38238","16268","21970","74",
"대전광역시","75~79세","2019 년","38878","16678","22200","75.1","38813","16650","22163","75.1",
"대전광역시","75~79세","2020 년","39473","17127","22346","76.6","39406","17094","22312","76.6",
"대전광역시","75~79세","2021 년","39281","17255","22026","78.3","39211","17227","21984","78.4",
"대전광역시","75~79세","2022 년","39010","17212","21798","79","38907","17171","21736","79",
"대전광역시","75~79세","2023 년","41213","18462","22751","81.1","41109","18420","22689","81.2",
"대전광역시","80~84세","2015 년","19557","6750","12807","52.7","19517","6733","12784","52.7",
"대전광역시","80~84세","2016 년","21609","7501","14108","53.2","21571","7482","14089","53.1",
"대전광역시","80~84세","2017 년","22715","8174","14541","56.2","22681","8160","14521","56.2",
"대전광역시","80~84세","2018 년","24513","9024","15489","58.3","24486","9013","15473","58.2",
"대전광역시","80~84세","2019 년","26176","9803","16373","59.9","26133","9789","16344","59.9",
"대전광역시","80~84세","2020 년","26903","10185","16718","60.9","26851","10171","16680","61",
"대전광역시","80~84세","2021 년","28204","10902","17302","63","28145","10885","17260","63.1",
"대전광역시","80~84세","2022 년","31003","12231","18772","65.2","30945","12214","18731","65.2",
"대전광역시","80~84세","2023 년","31897","12649","19248","65.7","31830","12626","19204","65.7",
"대전광역시","85~89세","2015 년","9110","2511","6599","38.1","9090","2501","6589","38",
"대전광역시","85~89세","2016 년","10019","2719","7300","37.2","10001","2710","7291","37.2",
"대전광역시","85~89세","2017 년","10780","3012","7768","38.8","10766","3007","7759","38.8",
"대전광역시","85~89세","2018 년","11644","3371","8273","40.7","11633","3365","8268","40.7",
"대전광역시","85~89세","2019 년","12719","3790","8929","42.4","12702","3782","8920","42.4",
"대전광역시","85~89세","2020 년","14007","4296","9711","44.2","13992","4289","9703","44.2",
"대전광역시","85~89세","2021 년","15320","4792","10528","45.5","15308","4786","10522","45.5",
"대전광역시","85~89세","2022 년","16009","5139","10870","47.3","15993","5133","10860","47.3",
"대전광역시","85~89세","2023 년","17172","5594","11578","48.3","17149","5586","11563","48.3",
"대전광역시","90~94세","2015 년","3097","708","2389","29.6","3092","705","2387","29.5",
"대전광역시","90~94세","2016 년","3337","770","2567","30","3334","768","2566","29.9",
"대전광역시","90~94세","2017 년","3631","851","2780","30.6","3626","848","2778","30.5",
"대전광역시","90~94세","2018 년","3982","962","3020","31.9","3977","961","3016","31.9",
"대전광역시","90~94세","2019 년","4378","1019","3359","30.3","4368","1013","3355","30.2",
"대전광역시","90~94세","2020 년","4921","1149","3772","30.5","4912","1144","3768","30.4",
"대전광역시","90~94세","2021 년","5257","1204","4053","29.7","5250","1200","4050","29.6",
"대전광역시","90~94세","2022 년","5613","1348","4265","31.6","5607","1344","4263","31.5",
"대전광역시","90~94세","2023 년","6020","1501","4519","33.2","6016","1498","4518","33.2",
"대전광역시","95~99세","2015 년","609","143","466","30.7","606","142","464","30.6",
"대전광역시","95~99세","2016 년","701","159","542","29.3","698","158","540","29.3",
"대전광역시","95~99세","2017 년","797","169","628","26.9","795","168","627","26.8",
"대전광역시","95~99세","2018 년","930","185","745","24.8","928","184","744","24.7",
"대전광역시","95~99세","2019 년","997","194","803","24.2","994","193","801","24.1",
"대전광역시","95~99세","2020 년","1019","176","843","20.9","1019","176","843","20.9",
"대전광역시","95~99세","2021 년","1094","202","892","22.6","1094","202","892","22.6",
"대전광역시","95~99세","2022 년","1150","209","941","22.2","1148","208","940","22.1",
"대전광역시","95~99세","2023 년","1287","244","1043","23.4","1283","242","1041","23.2",
"대전광역시","100세이상","2015 년","98","16","82","19.5","98","16","82","19.5",
"대전광역시","100세이상","2016 년","113","15","98","15.3","113","15","98","15.3",
"대전광역시","100세이상","2017 년","114","25","89","28.1","114","25","89","28.1",
"대전광역시","100세이상","2018 년","106","15","91","16.5","106","15","91","16.5",
"대전광역시","100세이상","2019 년","113","21","92","22.8","113","21","92","22.8",
"대전광역시","100세이상","2020 년","125","27","98","27.6","124","26","98","26.5",
"대전광역시","100세이상","2021 년","166","27","139","19.4","165","26","139","18.7",
"대전광역시","100세이상","2022 년","183","29","154","18.8","182","28","154","18.2",
"대전광역시","100세이상","2023 년","199","32","167","19.2","199","32","167","19.2",
"대전광역시","15세미만","2015 년","223618","115467","108151","106.8","222755","115028","107727","106.8",
"대전광역시","15세미만","2016 년","216008","111720","104288","107.1","215110","111278","103832","107.2",
"대전광역시","15세미만","2017 년","208072","107318","100754","106.5","207395","106972","100423","106.5",
"대전광역시","15세미만","2018 년","199342","102813","96529","106.5","198445","102352","96093","106.5",
"대전광역시","15세미만","2019 년","190706","98212","92494","106.2","189496","97590","91906","106.2",
"대전광역시","15세미만","2020 년","183773","94419","89354","105.7","182691","93856","88835","105.7",
"대전광역시","15세미만","2021 년","176486","90746","85740","105.8","175333","90172","85161","105.9",
"대전광역시","15세미만","2022 년","169677","87321","82356","106","168546","86745","81801","106",
"대전광역시","15세미만","2023 년","162571","83713","78858","106.2","161649","83265","78384","106.2",
"대전광역시","15~64세","2015 년","1150471","586392","564079","104","1132777","578144","554633","104.2",
"대전광역시","15~64세","2016 년","1148264","585836","562428","104.2","1130000","577285","552715","104.4",
"대전광역시","15~64세","2017 년","1138176","580699","557477","104.2","1118847","571573","547274","104.4",
"대전광역시","15~64세","2018 년","1124656","573883","550773","104.2","1103250","563625","539625","104.4",
"대전광역시","15~64세","2019 년","1111247","567527","543720","104.4","1088010","556385","531625","104.7",
"대전광역시","15~64세","2020 년","1095519","558380","537139","104","1074436","548769","525667","104.4",
"대전광역시","15~64세","2021 년","1082385","552580","529805","104.3","1061042","543005","518037","104.8",
"대전광역시","15~64세","2022 년","1071649","546956","524693","104.2","1047385","535862","511523","104.8",
"대전광역시","15~64세","2023 년","1063350","543411","519939","104.5","1035768","530688","505080","105.1",
"대전광역시","65세이상","2015 년","164305","70384","93921","74.9","163782","70138","93644","74.9",
"대전광역시","65세이상","2016 년","171173","73415","97758","75.1","170648","73186","97462","75.1",
"대전광역시","65세이상","2017 년","179601","77701","101900","76.3","179073","77470","101603","76.2",
"대전광역시","65세이상","2018 년","187216","81339","105877","76.8","186661","81099","105562","76.8",
"대전광역시","65세이상","2019 년","196886","85846","111040","77.3","196186","85546","110640","77.3",
"대전광역시","65세이상","2020 년","209143","91550","117593","77.9","208380","91227","117153","77.9",
"대전광역시","65세이상","2021 년","220869","97155","123714","78.5","220102","96830","123272","78.5",
"대전광역시","65세이상","2022 년","232336","102850","129486","79.4","231448","102488","128960","79.5",
"대전광역시","65세이상","2023 년","244415","108680","135735","80.1","243485","108288","135197","80.1",
"대전광역시","85세이상","2015 년","12914","3378","9536","35.4","12886","3364","9522","35.3",
"대전광역시","85세이상","2016 년","14170","3663","10507","34.9","14146","3651","10495","34.8",
"대전광역시","85세이상","2017 년","15322","4057","11265","36","15301","4048","11253","36",
"대전광역시","85세이상","2018 년","16662","4533","12129","37.4","16644","4525","12119","37.3",
"대전광역시","85세이상","2019 년","18207","5024","13183","38.1","18177","5009","13168","38",
"대전광역시","85세이상","2020 년","20072","5648","14424","39.2","20047","5635","14412","39.1",
"대전광역시","85세이상","2021 년","21837","6225","15612","39.9","21817","6214","15603","39.8",
"대전광역시","85세이상","2022 년","22955","6725","16230","41.4","22930","6713","16217","41.4",
"대전광역시","85세이상","2023 년","24678","7371","17307","42.6","24647","7358","17289","42.6",
"대전광역시","평균연령","2015 년","38.6","37.5","39.6","","38.6","37.6","39.7","",
"대전광역시","평균연령","2016 년","39.1","38","40.2","","39.2","38.1","40.3","",
"대전광역시","평균연령","2017 년","39.6","38.6","40.7","","39.7","38.6","40.8","",
"대전광역시","평균연령","2018 년","40.2","39.1","41.3","","40.3","39.2","41.5","",
"대전광역시","평균연령","2019 년","40.8","39.7","41.9","","41","39.8","42.1","",
"대전광역시","평균연령","2020 년","41.4","40.3","42.5","","41.5","40.4","42.6","",
"대전광역시","평균연령","2021 년","42","40.9","43.1","","42.1","41","43.3","",
"대전광역시","평균연령","2022 년","42.5","41.3","43.6","","42.6","41.5","43.8","",
"대전광역시","평균연령","2023 년","43","41.9","44.2","","43.2","42","44.4","",
"대전광역시","중위연령","2015 년","38.8","37.5","40","","39","37.7","40.2","",
"대전광역시","중위연령","2016 년","39.4","38","40.7","","39.6","38.2","40.9","",
"대전광역시","중위연령","2017 년","40","38.6","41.3","","40.2","38.8","41.6","",
"대전광역시","중위연령","2018 년","40.7","39.2","42.1","","40.9","39.4","42.3","",
"대전광역시","중위연령","2019 년","41.3","39.9","42.8","","41.6","40.1","43.1","",
"대전광역시","중위연령","2020 년","42","40.6","43.4","","42.2","40.8","43.7","",
"대전광역시","중위연령","2021 년","42.6","41.2","44.1","","42.8","41.4","44.4","",
"대전광역시","중위연령","2022 년","43.1","41.7","44.6","","43.5","42","45","",
"대전광역시","중위연령","2023 년","43.7","42.3","45.2","","44.1","42.6","45.7","",
"울산광역시","합계","2015 년","1166615","606924","559691","108.4","1136755","587603","549152","107",
"울산광역시","합계","2016 년","1166033","605618","560415","108.1","1137241","587458","549783","106.9",
"울산광역시","합계","2017 년","1157077","600093","556984","107.7","1130476","583739","546737","106.8",
"울산광역시","합계","2018 년","1150116","595795","554321","107.5","1122954","579263","543691","106.5",
"울산광역시","합계","2019 년","1143692","591965","551727","107.3","1115088","574546","540542","106.3",
"울산광역시","합계","2020 년","1135423","585978","549445","106.6","1108528","570131","538397","105.9",
"울산광역시","합계","2021 년","1120753","578207","542546","106.6","1095365","563428","531937","105.9",
"울산광역시","합계","2022 년","1110516","573080","537436","106.6","1084164","557386","526778","105.8",
"울산광역시","합계","2023 년","1107432","573506","533926","107.4","1075762","553006","522756","105.8",
"울산광역시","0~4세","2015 년","59157","30399","28758","105.7","58526","30063","28463","105.6",
"울산광역시","0~4세","2016 년","58236","29866","28370","105.3","57642","29570","28072","105.3",
"울산광역시","0~4세","2017 년","54853","28223","26630","106","54349","27960","26389","106",
"울산광역시","0~4세","2018 년","51327","26424","24903","106.1","50870","26198","24672","106.2",
"울산광역시","0~4세","2019 년","47359","24435","22924","106.6","46838","24178","22660","106.7",
"울산광역시","0~4세","2020 년","42442","21750","20692","105.1","41958","21497","20461","105.1",
"울산광역시","0~4세","2021 년","37456","19235","18221","105.6","37024","19009","18015","105.5",
"울산광역시","0~4세","2022 년","33711","17181","16530","103.9","33268","16962","16306","104",
"울산광역시","0~4세","2023 년","30627","15605","15022","103.9","30233","15401","14832","103.8",
"울산광역시","5~9세","2015 년","56490","29405","27085","108.6","56157","29232","26925","108.6",
"울산광역시","5~9세","2016 년","57741","30044","27697","108.5","57376","29846","27530","108.4",
"울산광역시","5~9세","2017 년","57688","29930","27758","107.8","57415","29781","27634","107.8",
"울산광역시","5~9세","2018 년","57107","29557","27550","107.3","56852","29429","27423","107.3",
"울산광역시","5~9세","2019 년","57292","29532","27760","106.4","56923","29339","27584","106.4",
"울산광역시","5~9세","2020 년","56827","29269","27558","106.2","56469","29070","27399","106.1",
"울산광역시","5~9세","2021 년","55219","28432","26787","106.1","54807","28227","26580","106.2",
"울산광역시","5~9세","2022 년","52186","26919","25267","106.5","51708","26681","25027","106.6",
"울산광역시","5~9세","2023 년","48913","25257","23656","106.8","48486","25048","23438","106.9",
"울산광역시","10~14세","2015 년","58494","30946","27548","112.3","58348","30883","27465","112.4",
"울산광역시","10~14세","2016 년","55159","29030","26129","111.1","55009","28969","26040","111.2",
"울산광역시","10~14세","2017 년","54576","28766","25810","111.5","54428","28702","25726","111.6",
"울산광역시","10~14세","2018 년","54425","28504","25921","110","54249","28412","25837","110",
"울산광역시","10~14세","2019 년","54052","28178","25874","108.9","53836","28060","25776","108.9",
"울산광역시","10~14세","2020 년","55024","28642","26382","108.6","54809","28522","26287","108.5",
"울산광역시","10~14세","2021 년","55972","29159","26813","108.7","55716","29013","26703","108.7",
"울산광역시","10~14세","2022 년","55966","29057","26909","108","55648","28883","26765","107.9",
"울산광역시","10~14세","2023 년","55478","28769","26709","107.7","55132","28576","26556","107.6",
"울산광역시","15~19세","2015 년","77393","42198","35195","119.9","76966","41961","35005","119.9",
"울산광역시","15~19세","2016 년","73137","39835","33302","119.6","72705","39585","33120","119.5",
"울산광역시","15~19세","2017 년","67585","36583","31002","118","67201","36365","30836","117.9",
"울산광역시","15~19세","2018 년","63055","34433","28622","120.3","62598","34181","28417","120.3",
"울산광역시","15~19세","2019 년","58614","31852","26762","119","58110","31578","26532","119",
"울산광역시","15~19세","2020 년","54045","29197","24848","117.5","53698","29018","24680","117.6",
"울산광역시","15~19세","2021 년","50920","27400","23520","116.5","50698","27298","23400","116.7",
"울산광역시","15~19세","2022 년","50564","27077","23487","115.3","50252","26919","23333","115.4",
"울산광역시","15~19세","2023 년","50520","26929","23591","114.1","50049","26637","23412","113.8",
"울산광역시","20~24세","2015 년","79289","46427","32862","141.3","76771","44865","31906","140.6",
"울산광역시","20~24세","2016 년","78196","46055","32141","143.3","75870","44631","31239","142.9",
"울산광역시","20~24세","2017 년","75679","44291","31388","141.1","73591","43112","30479","141.4",
"울산광역시","20~24세","2018 년","73066","42595","30471","139.8","70594","41104","29490","139.4",
"울산광역시","20~24세","2019 년","70145","40951","29194","140.3","67440","39247","28193","139.2",
"울산광역시","20~24세","2020 년","67960","39258","28702","136.8","65714","37891","27823","136.2",
"울산광역시","20~24세","2021 년","62607","36277","26330","137.8","60707","35140","25567","137.4",
"울산광역시","20~24세","2022 년","56591","32929","23662","139.2","54844","31836","23008","138.4",
"울산광역시","20~24세","2023 년","52179","30751","21428","143.5","49978","29220","20758","140.8",
"울산광역시","25~29세","2015 년","75299","42924","32375","132.6","69937","39255","30682","127.9",
"울산광역시","25~29세","2016 년","76427","43427","33000","131.6","71351","40031","31320","127.8",
"울산광역시","25~29세","2017 년","76201","43260","32941","131.3","71788","40371","31417","128.5",
"울산광역시","25~29세","2018 년","76961","43594","33367","130.7","72681","40823","31858","128.1",
"울산광역시","25~29세","2019 년","76543","43548","32995","132","72073","40647","31426","129.3",
"울산광역시","25~29세","2020 년","75712","42971","32741","131.2","71870","40592","31278","129.8",
"울산광역시","25~29세","2021 년","74109","42469","31640","134.2","70754","40407","30347","133.1",
"울산광역시","25~29세","2022 년","71995","41431","30564","135.6","68565","39218","29347","133.6",
"울산광역시","25~29세","2023 년","70532","41019","29513","139","66163","37906","28257","134.1",
"울산광역시","30~34세","2015 년","91323","49294","42029","117.3","86497","45778","40719","112.4",
"울산광역시","30~34세","2016 년","85927","46315","39612","116.9","81222","43031","38191","112.7",
"울산광역시","30~34세","2017 년","79461","42926","36535","117.5","74938","39845","35093","113.5",
"울산광역시","30~34세","2018 년","74711","40707","34004","119.7","70161","37714","32447","116.2",
"울산광역시","30~34세","2019 년","72465","39810","32655","121.9","67734","36765","30969","118.7",
"울산광역시","30~34세","2020 년","70942","39071","31871","122.6","66456","36280","30176","120.2",
"울산광역시","30~34세","2021 년","69957","38538","31419","122.7","65838","36054","29784","121.1",
"울산광역시","30~34세","2022 년","70718","39353","31365","125.5","66420","36601","29819","122.7",
"울산광역시","30~34세","2023 년","72836","41254","31582","130.6","67487","37376","30111","124.1",
"울산광역시","35~39세","2015 년","93835","49651","44184","112.4","90522","47298","43224","109.4",
"울산광역시","35~39세","2016 년","96413","51058","45355","112.6","93186","48820","44366","110",
"울산광역시","35~39세","2017 년","97287","51408","45879","112.1","94144","49327","44817","110.1",
"울산광역시","35~39세","2018 년","96923","50903","46020","110.6","93593","48690","44903","108.4",
"울산광역시","35~39세","2019 년","93355","49032","44323","110.6","89874","46765","43109","108.5",
"울산광역시","35~39세","2020 년","86575","45468","41107","110.6","83173","43341","39832","108.8",
"울산광역시","35~39세","2021 년","80244","42084","38160","110.3","76733","39946","36787","108.6",
"울산광역시","35~39세","2022 년","74606","39559","35047","112.9","70859","37240","33619","110.8",
"울산광역시","35~39세","2023 년","71357","38644","32713","118.1","66381","35264","31117","113.3",
"울산광역시","40~44세","2015 년","101733","51327","50406","101.8","98719","49270","49449","99.6",
"울산광역시","40~44세","2016 년","95932","48662","47270","102.9","93265","46866","46399","101",
"울산광역시","40~44세","2017 년","92872","47481","45391","104.6","90518","45947","44571","103.1",
"울산광역시","40~44세","2018 년","89675","46287","43388","106.7","87248","44780","42468","105.4",
"울산광역시","40~44세","2019 년","88494","46001","42493","108.3","85918","44414","41504","107",
"울산광역시","40~44세","2020 년","90201","46999","43202","108.8","87657","45455","42202","107.7",
"울산광역시","40~44세","2021 년","91723","47870","43853","109.2","89219","46369","42850","108.2",
"울산광역시","40~44세","2022 년","92553","48183","44370","108.6","89876","46581","43295","107.6",
"울산광역시","40~44세","2023 년","92922","48464","44458","109","89540","46246","43294","106.8",
"울산광역시","45~49세","2015 년","111764","56073","55691","100.7","108684","54192","54492","99.4",
"울산광역시","45~49세","2016 년","111218","55095","56123","98.2","108245","53344","54901","97.2",
"울산광역시","45~49세","2017 년","109101","54251","54850","98.9","106307","52596","53711","97.9",
"울산광역시","45~49세","2018 년","105641","52547","53094","99","102977","50978","51999","98",
"울산광역시","45~49세","2019 년","102387","50955","51432","99.1","99756","49394","50362","98.1",
"울산광역시","45~49세","2020 년","98136","48975","49161","99.6","95717","47592","48125","98.9",
"울산광역시","45~49세","2021 년","92115","46281","45834","101","89944","45023","44921","100.2",
"울산광역시","45~49세","2022 년","89379","45295","44084","102.7","87280","44053","43227","101.9",
"울산광역시","45~49세","2023 년","86753","44518","42235","105.4","84334","43079","41255","104.4",
"울산광역시","50~54세","2015 년","108010","56240","51770","108.6","105305","54696","50609","108.1",
"울산광역시","50~54세","2016 년","105923","55295","50628","109.2","103171","53710","49461","108.6",
"울산광역시","50~54세","2017 년","105196","54224","50972","106.4","102638","52771","49867","105.8",
"울산광역시","50~54세","2018 년","106434","54185","52249","103.7","103971","52781","51190","103.1",
"울산광역시","50~54세","2019 년","108271","54637","53634","101.9","105774","53192","52582","101.2",
"울산광역시","50~54세","2020 년","107401","53606","53795","99.6","104946","52214","52732","99",
"울산광역시","50~54세","2021 년","106836","52747","54089","97.5","104462","51408","53054","96.9",
"울산광역시","50~54세","2022 년","105043","51982","53061","98","102605","50613","51992","97.3",
"울산광역시","50~54세","2023 년","102249","50738","51511","98.5","99739","49267","50472","97.6",
"울산광역시","55~59세","2015 년","92333","47354","44979","105.3","90586","46337","44249","104.7",
"울산광역시","55~59세","2016 년","98668","50553","48115","105.1","97004","49595","47409","104.6",
"울산광역시","55~59세","2017 년","101675","52379","49296","106.3","100119","51507","48612","106",
"울산광역시","55~59세","2018 년","103394","53366","50028","106.7","101628","52383","49245","106.4",
"울산광역시","55~59세","2019 년","103128","53237","49891","106.7","101210","52152","49058","106.3",
"울산광역시","55~59세","2020 년","102721","53128","49593","107.1","100781","52055","48726","106.8",
"울산광역시","55~59세","2021 년","100277","52104","48173","108.2","98271","50964","47307","107.7",
"울산광역시","55~59세","2022 년","100257","51488","48769","105.6","98172","50302","47870","105.1",
"울산광역시","55~59세","2023 년","102135","51857","50278","103.1","99985","50628","49357","102.6",
"울산광역시","60~64세","2015 년","60131","30765","29366","104.8","59096","30172","28924","104.3",
"울산광역시","60~64세","2016 년","65981","33528","32453","103.3","64918","32944","31974","103",
"울산광역시","60~64세","2017 년","70485","35647","34838","102.3","69437","35073","34364","102.1",
"울산광역시","60~64세","2018 년","75971","38500","37471","102.7","74954","37945","37009","102.5",
"울산광역시","60~64세","2019 년","81602","41273","40329","102.3","80550","40697","39853","102.1",
"울산광역시","60~64세","2020 년","86667","43835","42832","102.3","85533","43219","42314","102.1",
"울산광역시","60~64세","2021 년","92550","46838","45712","102.5","91485","46260","45225","102.3",
"울산광역시","60~64세","2022 년","95241","48382","46859","103.3","94139","47781","46358","103.1",
"울산광역시","60~64세","2023 년","97533","49697","47836","103.9","96196","48953","47243","103.6",
"울산광역시","65~69세","2015 년","38273","19561","18712","104.5","37880","19351","18529","104.4",
"울산광역시","65~69세","2016 년","41329","21084","20245","104.1","40885","20861","20024","104.2",
"울산광역시","65~69세","2017 년","44638","22744","21894","103.9","44176","22514","21662","103.9",
"울산광역시","65~69세","2018 년","46875","23702","23173","102.3","46401","23480","22921","102.4",
"울산광역시","65~69세","2019 년","50234","25279","24955","101.3","49725","25029","24696","101.3",
"울산광역시","65~69세","2020 년","56099","28034","28065","99.9","55525","27756","27769","100",
"울산광역시","65~69세","2021 년","61337","30531","30806","99.1","60758","30231","30527","99",
"울산광역시","65~69세","2022 년","65839","32687","33152","98.6","65218","32356","32862","98.5",
"울산광역시","65~69세","2023 년","71083","35263","35820","98.4","70388","34896","35492","98.3",
"울산광역시","70~74세","2015 년","26989","12458","14531","85.7","26830","12388","14442","85.8",
"울산광역시","70~74세","2016 년","27002","12710","14292","88.9","26842","12644","14198","89.1",
"울산광역시","70~74세","2017 년","27754","13296","14458","92","27599","13234","14365","92.1",
"울산광역시","70~74세","2018 년","29859","14549","15310","95","29695","14481","15214","95.2",
"울산광역시","70~74세","2019 년","32533","16105","16428","98","32332","16019","16313","98.2",
"울산광역시","70~74세","2020 년","35372","17512","17860","98.1","35148","17433","17715","98.4",
"울산광역시","70~74세","2021 년","38229","18903","19326","97.8","37975","18806","19169","98.1",
"울산광역시","70~74세","2022 년","41386","20423","20963","97.4","41101","20303","20798","97.6",
"울산광역시","70~74세","2023 년","43774","21494","22280","96.5","43441","21361","22080","96.7",
"울산광역시","75~79세","2015 년","18581","7259","11322","64.1","18484","7237","11247","64.3",
"울산광역시","75~79세","2016 년","19695","7936","11759","67.5","19596","7905","11691","67.6",
"울산광역시","75~79세","2017 년","21672","9052","12620","71.7","21566","9015","12551","71.8",
"울산광역시","75~79세","2018 년","22972","9794","13178","74.3","22860","9756","13104","74.5",
"울산광역시","75~79세","2019 년","23579","10146","13433","75.5","23467","10106","13361","75.6",
"울산광역시","75~79세","2020 년","23848","10472","13376","78.3","23725","10428","13297","78.4",
"울산광역시","75~79세","2021 년","24052","10775","13277","81.2","23928","10736","13192","81.4",
"울산광역시","75~79세","2022 년","24925","11420","13505","84.6","24790","11378","13412","84.8",
"울산광역시","75~79세","2023 년","26883","12555","14328","87.6","26729","12505","14224","87.9",
"울산광역시","80~84세","2015 년","10721","3317","7404","44.8","10676","3308","7368","44.9",
"울산광역시","80~84세","2016 년","11739","3660","8079","45.3","11685","3653","8032","45.5",
"울산광역시","80~84세","2017 년","12441","4006","8435","47.5","12381","4000","8381","47.7",
"울산광역시","80~84세","2018 년","13216","4299","8917","48.2","13151","4285","8866","48.3",
"울산광역시","80~84세","2019 년","14188","4853","9335","52","14119","4834","9285","52.1",
"울산광역시","80~84세","2020 년","15088","5355","9733","55","15016","5336","9680","55.1",
"울산광역시","80~84세","2021 년","15923","5852","10071","58.1","15850","5831","10019","58.2",
"울산광역시","80~84세","2022 년","17738","6762","10976","61.6","17643","6734","10909","61.7",
"울산광역시","80~84세","2023 년","18983","7441","11542","64.5","18878","7404","11474","64.5",
"울산광역시","85~89세","2015 년","4854","1021","3833","26.6","4834","1016","3818","26.6",
"울산광역시","85~89세","2016 년","5233","1147","4086","28.1","5202","1140","4062","28.1",
"울산광역시","85~89세","2017 년","5619","1293","4326","29.9","5593","1288","4305","29.9",
"울산광역시","85~89세","2018 년","6067","1496","4571","32.7","6039","1492","4547","32.8",
"울산광역시","85~89세","2019 년","6712","1717","4995","34.4","6682","1710","4972","34.4",
"울산광역시","85~89세","2020 년","7394","1968","5426","36.3","7374","1964","5410","36.3",
"울산광역시","85~89세","2021 년","8006","2166","5840","37.1","7986","2162","5824","37.1",
"울산광역시","85~89세","2022 년","8435","2350","6085","38.6","8406","2346","6060","38.7",
"울산광역시","85~89세","2023 년","8964","2552","6412","39.8","8925","2543","6382","39.8",
"울산광역시","90~94세","2015 년","1608","250","1358","18.4","1600","247","1353","18.3",
"울산광역시","90~94세","2016 년","1707","257","1450","17.7","1698","253","1445","17.5",
"울산광역시","90~94세","2017 년","1864","275","1589","17.3","1860","274","1586","17.3",
"울산광역시","90~94세","2018 년","1966","288","1678","17.2","1962","286","1676","17.1",
"울산광역시","90~94세","2019 년","2247","364","1883","19.3","2236","360","1876","19.2",
"울산광역시","90~94세","2020 년","2406","403","2003","20.1","2396","403","1993","20.2",
"울산광역시","90~94세","2021 년","2591","470","2121","22.2","2582","469","2113","22.2",
"울산광역시","90~94세","2022 년","2750","524","2226","23.5","2739","522","2217","23.5",
"울산광역시","90~94세","2023 년","3006","614","2392","25.7","2993","611","2382","25.7",
"울산광역시","95~99세","2015 년","297","51","246","20.7","296","50","246","20.3",
"울산광역시","95~99세","2016 년","336","59","277","21.3","335","58","277","20.9",
"울산광역시","95~99세","2017 년","385","56","329","17","383","55","328","16.8",
"울산광역시","95~99세","2018 년","430","64","366","17.5","429","64","365","17.5",
"울산광역시","95~99세","2019 년","450","58","392","14.8","449","58","391","14.8",
"울산광역시","95~99세","2020 년","523","64","459","13.9","523","64","459","13.9",
"울산광역시","95~99세","2021 년","566","71","495","14.3","564","70","494","14.2",
"울산광역시","95~99세","2022 년","581","73","508","14.4","579","72","507","14.2",
"울산광역시","95~99세","2023 년","629","77","552","13.9","629","77","552","13.9",
"울산광역시","100세이상","2015 년","41","X","37","10.8","41","X","37","10.8",
"울산광역시","100세이상","2016 년","34","X","32","6.3","34","X","32","6.3",
"울산광역시","100세이상","2017 년","45","X","43","4.7","45","X","43","4.7",
"울산광역시","100세이상","2018 년","41","X","40","2.5","41","X","40","2.5",
"울산광역시","100세이상","2019 년","42","X","40","5","42","X","40","5",
"울산광역시","100세이상","2020 년","40","X","39","2.6","40","X","39","2.6",
"울산광역시","100세이상","2021 년","64","5","59","8.5","64","5","59","8.5",
"울산광역시","100세이상","2022 년","52","5","47","10.6","52","5","47","10.6",
"울산광역시","100세이상","2023 년","76","8","68","11.8","76","8","68","11.8",
"울산광역시","15세미만","2015 년","174141","90750","83391","108.8","173031","90178","82853","108.8",
"울산광역시","15세미만","2016 년","171136","88940","82196","108.2","170027","88385","81642","108.3",
"울산광역시","15세미만","2017 년","167117","86919","80198","108.4","166192","86443","79749","108.4",
"울산광역시","15세미만","2018 년","162859","84485","78374","107.8","161971","84039","77932","107.8",
"울산광역시","15세미만","2019 년","158703","82145","76558","107.3","157597","81577","76020","107.3",
"울산광역시","15세미만","2020 년","154293","79661","74632","106.7","153236","79089","74147","106.7",
"울산광역시","15세미만","2021 년","148647","76826","71821","107","147547","76249","71298","106.9",
"울산광역시","15세미만","2022 년","141863","73157","68706","106.5","140624","72526","68098","106.5",
"울산광역시","15세미만","2023 년","135018","69631","65387","106.5","133851","69025","64826","106.5",
"울산광역시","15~64세","2015 년","891110","472253","418857","112.7","863083","453824","409259","110.9",
"울산광역시","15~64세","2016 년","887822","469823","417999","112.4","860937","452557","408380","110.8",
"울산광역시","15~64세","2017 년","875542","462450","413092","111.9","850681","446914","403767","110.7",
"울산광역시","15~64세","2018 년","865831","457117","408714","111.8","840405","441379","399026","110.6",
"울산광역시","15~64세","2019 년","855004","451296","403708","111.8","828439","434851","393588","110.5",
"울산광역시","15~64세","2020 년","840360","442508","397852","111.2","815545","427657","387888","110.3",
"울산광역시","15~64세","2021 년","821338","432608","388730","111.3","798111","418869","379242","110.4",
"울산광역시","15~64세","2022 년","806947","425679","381268","111.6","783012","411144","371868","110.6",
"울산광역시","15~64세","2023 년","799016","423871","375145","113","769852","404576","365276","110.8",
"울산광역시","65세이상","2015 년","101364","43921","57443","76.5","100641","43601","57040","76.4",
"울산광역시","65세이상","2016 년","107075","46855","60220","77.8","106277","46516","59761","77.8",
"울산광역시","65세이상","2017 년","114418","50724","63694","79.6","113603","50382","63221","79.7",
"울산광역시","65세이상","2018 년","121426","54193","67233","80.6","120578","53845","66733","80.7",
"울산광역시","65세이상","2019 년","129985","58524","71461","81.9","129052","58118","70934","81.9",
"울산광역시","65세이상","2020 년","140770","63809","76961","82.9","139747","63385","76362","83",
"울산광역시","65세이상","2021 년","150768","68773","81995","83.9","149707","68310","81397","83.9",
"울산광역시","65세이상","2022 년","161706","74244","87462","84.9","160528","73716","86812","84.9",
"울산광역시","65세이상","2023 년","173398","80004","93394","85.7","172059","79405","92654","85.7",
"울산광역시","85세이상","2015 년","6800","1326","5474","24.2","6771","1317","5454","24.1",
"울산광역시","85세이상","2016 년","7310","1465","5845","25.1","7269","1453","5816","25",
"울산광역시","85세이상","2017 년","7913","1626","6287","25.9","7881","1619","6262","25.9",
"울산광역시","85세이상","2018 년","8504","1849","6655","27.8","8471","1843","6628","27.8",
"울산광역시","85세이상","2019 년","9451","2141","7310","29.3","9409","2130","7279","29.3",
"울산광역시","85세이상","2020 년","10363","2436","7927","30.7","10333","2432","7901","30.8",
"울산광역시","85세이상","2021 년","11227","2712","8515","31.8","11196","2706","8490","31.9",
"울산광역시","85세이상","2022 년","11818","2952","8866","33.3","11776","2945","8831","33.3",
"울산광역시","85세이상","2023 년","12675","3251","9424","34.5","12623","3239","9384","34.5",
"울산광역시","평균연령","2015 년","38.4","37.4","39.5","","38.4","37.4","39.5","",
"울산광역시","평균연령","2016 년","38.9","37.9","40","","39","38","40","",
"울산광역시","평균연령","2017 년","39.6","38.6","40.6","","39.6","38.6","40.7","",
"울산광역시","평균연령","2018 년","40.2","39.2","41.3","","40.2","39.2","41.3","",
"울산광역시","평균연령","2019 년","40.8","39.8","41.9","","40.9","39.9","42","",
"울산광역시","평균연령","2020 년","41.5","40.5","42.6","","41.6","40.6","42.6","",
"울산광역시","평균연령","2021 년","42.2","41.2","43.3","","42.3","41.3","43.4","",
"울산광역시","평균연령","2022 년","42.9","41.9","44.1","","43","42","44.1","",
"울산광역시","평균연령","2023 년","43.6","42.5","44.8","","43.8","42.7","44.9","",
"울산광역시","중위연령","2015 년","39.5","38.1","41.1","","39.7","38.2","41.1","",
"울산광역시","중위연령","2016 년","40.1","38.6","41.7","","40.3","38.8","41.8","",
"울산광역시","중위연령","2017 년","40.8","39.4","42.4","","41","39.6","42.5","",
"울산광역시","중위연령","2018 년","41.6","40.1","43.2","","41.7","40.3","43.3","",
"울산광역시","중위연령","2019 년","42.3","40.9","44","","42.6","41.1","44.1","",
"울산광역시","중위연령","2020 년","43.1","41.7","44.7","","43.3","41.9","44.9","",
"울산광역시","중위연령","2021 년","44","42.5","45.6","","44.2","42.7","45.8","",
"울산광역시","중위연령","2022 년","44.8","43.3","46.4","","45","43.6","46.6","",
"울산광역시","중위연령","2023 년","45.5","44","47.3","","45.9","44.4","47.5","",
"세종특별자치시","합계","2015 년","204088","103210","100878","102.3","199617","100455","99162","101.3",
"세종특별자치시","합계","2016 년","242507","122648","119859","102.3","237672","119765","117907","101.6",
"세종특별자치시","합계","2017 년","276589","139347","137242","101.5","271299","136217","135082","100.8",
"세종특별자치시","합계","2018 년","312374","157289","155085","101.4","305888","153402","152486","100.6",
"세종특별자치시","합계","2019 년","338136","170148","167988","101.3","330307","165288","165019","100.2",
"세종특별자치시","합계","2020 년","353933","177939","175994","101.1","346689","173541","173148","100.2",
"세종특별자치시","합계","2021 년","366227","183616","182611","100.6","359236","179460","179776","99.8",
"세종특별자치시","합계","2022 년","382589","192165","190424","100.9","375392","187982","187410","100.3",
"세종특별자치시","합계","2023 년","386261","193999","192262","100.9","378454","189304","189150","100.1",
"세종특별자치시","0~4세","2015 년","13898","7139","6759","105.6","13846","7108","6738","105.5",
"세종특별자치시","0~4세","2016 년","16725","8632","8093","106.7","16658","8592","8066","106.5",
"세종특별자치시","0~4세","2017 년","18887","9720","9167","106","18818","9678","9140","105.9",
"세종특별자치시","0~4세","2018 년","20864","10702","10162","105.3","20778","10654","10124","105.2",
"세종특별자치시","0~4세","2019 년","21785","11135","10650","104.6","21683","11074","10609","104.4",
"세종특별자치시","0~4세","2020 년","20858","10641","10217","104.1","20767","10589","10178","104",
"세종특별자치시","0~4세","2021 년","20047","10169","9878","102.9","19953","10124","9829","103",
"세종특별자치시","0~4세","2022 년","19130","9678","9452","102.4","19021","9628","9393","102.5",
"세종특별자치시","0~4세","2023 년","17513","8833","8680","101.8","17428","8792","8636","101.8",
"세종특별자치시","5~9세","2015 년","13946","7059","6887","102.5","13904","7043","6861","102.7",
"세종특별자치시","5~9세","2016 년","17134","8603","8531","100.8","17094","8585","8509","100.9",
"세종특별자치시","5~9세","2017 년","20036","10208","9828","103.9","19998","10185","9813","103.8",
"세종특별자치시","5~9세","2018 년","22684","11625","11059","105.1","22632","11597","11035","105.1",
"세종특별자치시","5~9세","2019 년","24398","12477","11921","104.7","24325","12438","11887","104.6",
"세종특별자치시","5~9세","2020 년","25681","13204","12477","105.8","25615","13170","12445","105.8",
"세종특별자치시","5~9세","2021 년","26421","13545","12876","105.2","26337","13504","12833","105.2",
"세종특별자치시","5~9세","2022 년","26426","13520","12906","104.8","26319","13471","12848","104.8",
"세종특별자치시","5~9세","2023 년","25750","13149","12601","104.3","25652","13101","12551","104.4",
"세종특별자치시","10~14세","2015 년","11867","6043","5824","103.8","11849","6032","5817","103.7",
"세종특별자치시","10~14세","2016 년","14118","7103","7015","101.3","14104","7099","7005","101.3",
"세종특별자치시","10~14세","2017 년","16808","8392","8416","99.7","16786","8387","8399","99.9",
"세종특별자치시","10~14세","2018 년","19613","9751","9862","98.9","19579","9744","9835","99.1",
"세종특별자치시","10~14세","2019 년","21380","10682","10698","99.9","21337","10670","10667","100",
"세종특별자치시","10~14세","2020 년","23301","11739","11562","101.5","23265","11728","11537","101.7",
"세종특별자치시","10~14세","2021 년","25139","12714","12425","102.3","25102","12700","12402","102.4",
"세종특별자치시","10~14세","2022 년","26630","13537","13093","103.4","26579","13512","13067","103.4",
"세종특별자치시","10~14세","2023 년","27047","13823","13224","104.5","26998","13802","13196","104.6",
"세종특별자치시","15~19세","2015 년","11981","6032","5949","101.4","11854","5969","5885","101.4",
"세종특별자치시","15~19세","2016 년","14111","7183","6928","103.7","13955","7100","6855","103.6",
"세종특별자치시","15~19세","2017 년","15821","8030","7791","103.1","15631","7933","7698","103.1",
"세종특별자치시","15~19세","2018 년","17348","8818","8530","103.4","17017","8623","8394","102.7",
"세종특별자치시","15~19세","2019 년","17841","8968","8873","101.1","17469","8744","8725","100.2",
"세종특별자치시","15~19세","2020 년","18999","9479","9520","99.6","18846","9392","9454","99.3",
"세종특별자치시","15~19세","2021 년","19452","9719","9733","99.9","19274","9638","9636","100",
"세종특별자치시","15~19세","2022 년","21845","10937","10908","100.3","21616","10826","10790","100.3",
"세종특별자치시","15~19세","2023 년","22820","11478","11342","101.2","22641","11372","11269","100.9",
"세종특별자치시","20~24세","2015 년","14433","7886","6547","120.5","13861","7554","6307","119.8",
"세종특별자치시","20~24세","2016 년","17254","9452","7802","121.1","16686","9137","7549","121",
"세종특별자치시","20~24세","2017 년","18151","9868","8283","119.1","17536","9518","8018","118.7",
"세종특별자치시","20~24세","2018 년","19692","10629","9063","117.3","18767","10094","8673","116.4",
"세종특별자치시","20~24세","2019 년","20804","11216","9588","117","19491","10351","9140","113.2",
"세종특별자치시","20~24세","2020 년","21654","11579","10075","114.9","20512","10843","9669","112.1",
"세종특별자치시","20~24세","2021 년","19793","10415","9378","111.1","18836","9842","8994","109.4",
"세종특별자치시","20~24세","2022 년","21524","11496","10028","114.6","20585","10960","9625","113.9",
"세종특별자치시","20~24세","2023 년","21275","11305","9970","113.4","20280","10727","9553","112.3",
"세종특별자치시","25~29세","2015 년","12090","6585","5505","119.6","11199","5976","5223","114.4",
"세종특별자치시","25~29세","2016 년","14806","7947","6859","115.9","13914","7374","6540","112.8",
"세종특별자치시","25~29세","2017 년","16675","8784","7891","111.3","15724","8177","7547","108.3",
"세종특별자치시","25~29세","2018 년","18783","9804","8979","109.2","17656","9069","8587","105.6",
"세종특별자치시","25~29세","2019 년","20867","10901","9966","109.4","19449","9953","9496","104.8",
"세종특별자치시","25~29세","2020 년","21226","11062","10164","108.8","19927","10202","9725","104.9",
"세종특별자치시","25~29세","2021 년","21559","11192","10367","108","20285","10349","9936","104.2",
"세종특별자치시","25~29세","2022 년","21977","11599","10378","111.8","20732","10787","9945","108.5",
"세종특별자치시","25~29세","2023 년","21471","11242","10229","109.9","20100","10334","9766","105.8",
"세종특별자치시","30~34세","2015 년","17322","8388","8934","93.9","16583","7909","8674","91.2",
"세종특별자치시","30~34세","2016 년","19952","9779","10173","96.1","19155","9278","9877","93.9",
"세종특별자치시","30~34세","2017 년","21563","10463","11100","94.3","20674","9913","10761","92.1",
"세종특별자치시","30~34세","2018 년","23853","11766","12087","97.3","22828","11097","11731","94.6",
"세종특별자치시","30~34세","2019 년","25627","12677","12950","97.9","24383","11840","12543","94.4",
"세종특별자치시","30~34세","2020 년","26074","12939","13135","98.5","24887","12173","12714","95.7",
"세종특별자치시","30~34세","2021 년","26697","13158","13539","97.2","25605","12444","13161","94.6",
"세종특별자치시","30~34세","2022 년","27717","13719","13998","98","26610","13015","13595","95.7",
"세종특별자치시","30~34세","2023 년","27713","13852","13861","99.9","26435","12983","13452","96.5",
"세종특별자치시","35~39세","2015 년","20153","10033","10120","99.1","19641","9701","9940","97.6",
"세종특별자치시","35~39세","2016 년","24898","12290","12608","97.5","24347","11940","12407","96.2",
"세종특별자치시","35~39세","2017 년","29326","14358","14968","95.9","28716","13988","14728","95",
"세종특별자치시","35~39세","2018 년","33736","16443","17293","95.1","32963","15978","16985","94.1",
"세종특별자치시","35~39세","2019 년","35451","17382","18069","96.2","34602","16872","17730","95.2",
"세종특별자치시","35~39세","2020 년","34999","17146","17853","96","34059","16575","17484","94.8",
"세종특별자치시","35~39세","2021 년","34311","16848","17463","96.5","33387","16273","17114","95.1",
"세종특별자치시","35~39세","2022 년","33398","16464","16934","97.2","32459","15891","16568","95.9",
"세종특별자치시","35~39세","2023 년","32169","16077","16092","99.9","31107","15403","15704","98.1",
"세종특별자치시","40~44세","2015 년","19823","10500","9323","112.6","19407","10220","9187","111.2",
"세종특별자치시","40~44세","2016 년","23274","12194","11080","110.1","22851","11925","10926","109.1",
"세종특별자치시","40~44세","2017 년","26892","13841","13051","106.1","26426","13544","12882","105.1",
"세종특별자치시","40~44세","2018 년","30228","15349","14879","103.2","29664","15016","14648","102.5",
"세종특별자치시","40~44세","2019 년","32778","16485","16293","101.2","32156","16132","16024","100.7",
"세종특별자치시","40~44세","2020 년","35241","17500","17741","98.6","34653","17166","17487","98.2",
"세종특별자치시","40~44세","2021 년","37893","18750","19143","97.9","37293","18411","18882","97.5",
"세종특별자치시","40~44세","2022 년","40300","19902","20398","97.6","39662","19530","20132","97",
"세종특별자치시","40~44세","2023 년","41019","20078","20941","95.9","40290","19648","20642","95.2",
"세종특별자치시","45~49세","2015 년","14761","8031","6730","119.3","14418","7843","6575","119.3",
"세종특별자치시","45~49세","2016 년","18891","10272","8619","119.2","18501","10045","8456","118.8",
"세종특별자치시","45~49세","2017 년","22720","12308","10412","118.2","22292","12071","10221","118.1",
"세종특별자치시","45~49세","2018 년","26319","14220","12099","117.5","25846","13937","11909","117",
"세종특별자치시","45~49세","2019 년","29517","15700","13817","113.6","28974","15368","13606","113",
"세종특별자치시","45~49세","2020 년","31435","16567","14868","111.4","30954","16289","14665","111.1",
"세종특별자치시","45~49세","2021 년","32533","16889","15644","108","32075","16630","15445","107.7",
"세종특별자치시","45~49세","2022 년","34218","17420","16798","103.7","33760","17176","16584","103.6",
"세종특별자치시","45~49세","2023 년","34911","17654","17257","102.3","34402","17378","17024","102.1",
"세종특별자치시","50~54세","2015 년","12815","6742","6073","111","12504","6573","5931","110.8",
"세종특별자치시","50~54세","2016 년","14335","7558","6777","111.5","13951","7344","6607","111.2",
"세종특별자치시","50~54세","2017 년","16342","8520","7822","108.9","15929","8286","7643","108.4",
"세종특별자치시","50~54세","2018 년","19174","9962","9212","108.1","18779","9743","9036","107.8",
"세종특별자치시","50~54세","2019 년","22016","11488","10528","109.1","21590","11238","10352","108.6",
"세종특별자치시","50~54세","2020 년","23999","12552","11447","109.7","23571","12309","11262","109.3",
"세종특별자치시","50~54세","2021 년","27097","14247","12850","110.9","26657","14007","12650","110.7",
"세종특별자치시","50~54세","2022 년","29285","15506","13779","112.5","28822","15254","13568","112.4",
"세종특별자치시","50~54세","2023 년","30625","16181","14444","112","30133","15925","14208","112.1",
"세종특별자치시","55~59세","2015 년","11545","5877","5668","103.7","11344","5764","5580","103.3",
"세종특별자치시","55~59세","2016 년","13770","6953","6817","102","13517","6819","6698","101.8",
"세종특별자치시","55~59세","2017 년","15936","8098","7838","103.3","15675","7961","7714","103.2",
"세종특별자치시","55~59세","2018 년","18027","9172","8855","103.6","17695","9004","8691","103.6",
"세종특별자치시","55~59세","2019 년","19389","9897","9492","104.3","18987","9689","9298","104.2",
"세종특별자치시","55~59세","2020 년","20097","10322","9775","105.6","19732","10139","9593","105.7",
"세종특별자치시","55~59세","2021 년","20287","10434","9853","105.9","19914","10240","9674","105.9",
"세종특별자치시","55~59세","2022 년","21304","10963","10341","106","20915","10747","10168","105.7",
"세종특별자치시","55~59세","2023 년","22451","11568","10883","106.3","22086","11350","10736","105.7",
"세종특별자치시","60~64세","2015 년","8351","4151","4200","98.8","8219","4073","4146","98.2",
"세종특별자치시","60~64세","2016 년","10247","5070","5177","97.9","10079","4977","5102","97.5",
"세종특별자치시","60~64세","2017 년","12034","5994","6040","99.2","11818","5875","5943","98.9",
"세종특별자치시","60~64세","2018 년","14202","7068","7134","99.1","13979","6946","7033","98.8",
"세종특별자치시","60~64세","2019 년","16003","7992","8011","99.8","15747","7854","7893","99.5",
"세종특별자치시","60~64세","2020 년","17376","8657","8719","99.3","17117","8519","8598","99.1",
"세종특별자치시","60~64세","2021 년","19271","9589","9682","99","19015","9460","9555","99",
"세종특별자치시","60~64세","2022 년","20345","10087","10258","98.3","20067","9964","10103","98.6",
"세종특별자치시","60~64세","2023 년","20756","10371","10385","99.9","20455","10233","10222","100.1",
"세종특별자치시","65~69세","2015 년","6253","3012","3241","92.9","6187","2975","3212","92.6",
"세종특별자치시","65~69세","2016 년","7153","3436","3717","92.4","7078","3396","3682","92.2",
"세종특별자치시","65~69세","2017 년","8195","3967","4228","93.8","8122","3926","4196","93.6",
"세종특별자치시","65~69세","2018 년","9251","4513","4738","95.3","9159","4456","4703","94.7",
"세종특별자치시","65~69세","2019 년","10237","4985","5252","94.9","10135","4928","5207","94.6",
"세종특별자치시","65~69세","2020 년","11668","5723","5945","96.3","11539","5651","5888","96",
"세종특별자치시","65~69세","2021 년","13331","6572","6759","97.2","13199","6501","6698","97.1",
"세종특별자치시","65~69세","2022 년","14517","7162","7355","97.4","14375","7089","7286","97.3",
"세종특별자치시","65~69세","2023 년","15807","7737","8070","95.9","15646","7656","7990","95.8",
"세종특별자치시","70~74세","2015 년","5412","2376","3036","78.3","5397","2370","3027","78.3",
"세종특별자치시","70~74세","2016 년","5584","2528","3056","82.7","5560","2517","3043","82.7",
"세종특별자치시","70~74세","2017 년","5775","2654","3121","85","5750","2640","3110","84.9",
"세종특별자치시","70~74세","2018 년","6377","2987","3390","88.1","6350","2971","3379","87.9",
"세종특별자치시","70~74세","2019 년","7160","3408","3752","90.8","7124","3390","3734","90.8",
"세종특별자치시","70~74세","2020 년","7929","3829","4100","93.4","7878","3806","4072","93.5",
"세종특별자치시","70~74세","2021 년","8462","4089","4373","93.5","8406","4063","4343","93.6",
"세종특별자치시","70~74세","2022 년","9286","4517","4769","94.7","9223","4488","4735","94.8",
"세종특별자치시","70~74세","2023 년","9668","4670","4998","93.4","9589","4635","4954","93.6",
"세종특별자치시","75~79세","2015 년","4504","1832","2672","68.6","4487","1825","2662","68.6",
"세종특별자치시","75~79세","2016 년","4833","1954","2879","67.9","4817","1950","2867","68",
"세종특별자치시","75~79세","2017 년","5421","2237","3184","70.3","5411","2235","3176","70.4",
"세종특별자치시","75~79세","2018 년","5710","2402","3308","72.6","5697","2398","3299","72.7",
"세종특별자치시","75~79세","2019 년","5793","2462","3331","73.9","5780","2458","3322","74",
"세종특별자치시","75~79세","2020 년","5872","2529","3343","75.7","5857","2524","3333","75.7",
"세종특별자치시","75~79세","2021 년","5869","2612","3257","80.2","5851","2605","3246","80.3",
"세종특별자치시","75~79세","2022 년","5967","2665","3302","80.7","5944","2657","3287","80.8",
"세종특별자치시","75~79세","2023 년","6295","2870","3425","83.8","6267","2861","3406","84",
"세종특별자치시","80~84세","2015 년","2981","1028","1953","52.6","2967","1025","1942","52.8",
"세종특별자치시","80~84세","2016 년","3287","1155","2132","54.2","3275","1151","2124","54.2",
"세종특별자치시","80~84세","2017 년","3576","1279","2297","55.7","3563","1275","2288","55.7",
"세종특별자치시","80~84세","2018 년","3835","1407","2428","57.9","3823","1405","2418","58.1",
"세종특별자치시","80~84세","2019 년","4045","1475","2570","57.4","4038","1473","2565","57.4",
"세종특별자치시","80~84세","2020 년","4178","1559","2619","59.5","4168","1554","2614","59.4",
"세종특별자치시","80~84세","2021 년","4387","1646","2741","60.1","4379","1644","2735","60.1",
"세종특별자치시","80~84세","2022 년","4853","1913","2940","65.1","4843","1909","2934","65.1",
"세종특별자치시","80~84세","2023 년","4903","1950","2953","66","4885","1945","2940","66.2",
"세종특별자치시","85~89세","2015 년","1396","373","1023","36.5","1393","372","1021","36.4",
"세종특별자치시","85~89세","2016 년","1559","422","1137","37.1","1554","419","1135","36.9",
"세종특별자치시","85~89세","2017 년","1754","479","1275","37.6","1753","478","1275","37.5",
"세종특별자치시","85~89세","2018 년","1918","505","1413","35.7","1916","504","1412","35.7",
"세종특별자치시","85~89세","2019 년","2154","618","1536","40.2","2148","616","1532","40.2",
"세종특별자치시","85~89세","2020 년","2348","689","1659","41.5","2344","689","1655","41.6",
"세종특별자치시","85~89세","2021 년","2587","793","1794","44.2","2579","790","1789","44.2",
"세종특별자치시","85~89세","2022 년","2671","832","1839","45.2","2665","830","1835","45.2",
"세종특별자치시","85~89세","2023 년","2780","889","1891","47","2775","888","1887","47.1",
"세종특별자치시","90~94세","2015 년","464","109","355","30.7","464","109","355","30.7",
"세종특별자치시","90~94세","2016 년","468","102","366","27.9","468","102","366","27.9",
"세종특별자치시","90~94세","2017 년","548","123","425","28.9","548","123","425","28.9",
"세종특별자치시","90~94세","2018 년","619","141","478","29.5","619","141","478","29.5",
"세종특별자치시","90~94세","2019 년","745","173","572","30.2","743","173","570","30.4",
"세종특별자치시","90~94세","2020 년","830","192","638","30.1","830","192","638","30.1",
"세종특별자치시","90~94세","2021 년","897","202","695","29.1","895","202","693","29.1",
"세종특별자치시","90~94세","2022 년","988","210","778","27","987","210","777","27",
"세종특별자치시","90~94세","2023 년","1042","227","815","27.9","1039","226","813","27.8",
"세종특별자치시","95~99세","2015 년","81","13","68","19.1","81","13","68","19.1",
"세종특별자치시","95~99세","2016 년","87","15","72","20.8","87","15","72","20.8",
"세종특별자치시","95~99세","2017 년","111","24","87","27.6","111","24","87","27.6",
"세종특별자치시","95~99세","2018 년","120","24","96","25","120","24","96","25",
"세종특별자치시","95~99세","2019 년","125","25","100","25","125","25","100","25",
"세종특별자치시","95~99세","2020 년","152","29","123","23.6","152","29","123","23.6",
"세종특별자치시","95~99세","2021 년","174","29","145","20","174","29","145","20",
"세종특별자치시","95~99세","2022 년","180","32","148","21.6","180","32","148","21.6",
"세종특별자치시","95~99세","2023 년","218","41","177","23.2","218","41","177","23.2",
"세종특별자치시","100세이상","2015 년","12","X","11","9.1","12","X","11","9.1",
"세종특별자치시","100세이상","2016 년","21","X","21","0","21","X","21","0",
"세종특별자치시","100세이상","2017 년","18","X","18","0","18","X","18","0",
"세종특별자치시","100세이상","2018 년","21","X","20","5","21","X","20","5",
"세종특별자치시","100세이상","2019 년","21","X","19","10.5","21","X","19","10.5",
"세종특별자치시","100세이상","2020 년","16","X","14","14.3","16","X","14","14.3",
"세종특별자치시","100세이상","2021 년","20","X","16","25","20","X","16","25",
"세종특별자치시","100세이상","2022 년","28","6","22","27.3","28","6","22","27.3",
"세종특별자치시","100세이상","2023 년","28","X","24","16.7","28","X","24","16.7",
"세종특별자치시","15세미만","2015 년","39711","20241","19470","104","39599","20183","19416","104",
"세종특별자치시","15세미만","2016 년","47977","24338","23639","103","47856","24276","23580","103",
"세종특별자치시","15세미만","2017 년","55731","28320","27411","103.3","55602","28250","27352","103.3",
"세종특별자치시","15세미만","2018 년","63161","32078","31083","103.2","62989","31995","30994","103.2",
"세종특별자치시","15세미만","2019 년","67563","34294","33269","103.1","67345","34182","33163","103.1",
"세종특별자치시","15세미만","2020 년","69840","35584","34256","103.9","69647","35487","34160","103.9",
"세종특별자치시","15세미만","2021 년","71607","36428","35179","103.6","71392","36328","35064","103.6",
"세종특별자치시","15세미만","2022 년","72186","36735","35451","103.6","71919","36611","35308","103.7",
"세종특별자치시","15세미만","2023 년","70310","35805","34505","103.8","70078","35695","34383","103.8",
"세종특별자치시","15~64세","2015 년","143274","74225","69049","107.5","139030","71582","67448","106.1",
"세종특별자치시","15~64세","2016 년","171538","88698","82840","107.1","166956","85939","81017","106.1",
"세종특별자치시","15~64세","2017 년","195460","100264","95196","105.3","190421","97266","93155","104.4",
"세종특별자치시","15~64세","2018 년","221362","113231","108131","104.7","215194","109507","105687","103.6",
"세종특별자치시","15~64세","2019 년","240293","122706","117587","104.4","232848","118041","114807","102.8",
"세종특별자치시","15~64세","2020 년","251100","127803","123297","103.7","244258","123607","120651","102.5",
"세종특별자치시","15~64세","2021 년","258893","131241","127652","102.8","252341","127294","125047","101.8",
"세종특별자치시","15~64세","2022 년","271913","138093","133820","103.2","265228","134150","131078","102.3",
"세종특별자치시","15~64세","2023 년","275210","139806","135404","103.3","267929","135353","132576","102.1",
"세종특별자치시","65세이상","2015 년","21103","8744","12359","70.8","20988","8690","12298","70.7",
"세종특별자치시","65세이상","2016 년","22992","9612","13380","71.8","22860","9550","13310","71.8",
"세종특별자치시","65세이상","2017 년","25398","10763","14635","73.5","25276","10701","14575","73.4",
"세종특별자치시","65세이상","2018 년","27851","11980","15871","75.5","27705","11900","15805","75.3",
"세종특별자치시","65세이상","2019 년","30280","13148","17132","76.7","30114","13065","17049","76.6",
"세종특별자치시","65세이상","2020 년","32993","14552","18441","78.9","32784","14447","18337","78.8",
"세종특별자치시","65세이상","2021 년","35727","15947","19780","80.6","35503","15838","19665","80.5",
"세종특별자치시","65세이상","2022 년","38490","17337","21153","82","38245","17221","21024","81.9",
"세종특별자치시","65세이상","2023 년","40741","18388","22353","82.3","40447","18256","22191","82.3",
"세종특별자치시","85세이상","2015 년","1953","496","1457","34","1950","495","1455","34",
"세종특별자치시","85세이상","2016 년","2135","539","1596","33.8","2130","536","1594","33.6",
"세종특별자치시","85세이상","2017 년","2431","626","1805","34.7","2430","625","1805","34.6",
"세종특별자치시","85세이상","2018 년","2678","671","2007","33.4","2676","670","2006","33.4",
"세종특별자치시","85세이상","2019 년","3045","818","2227","36.7","3037","816","2221","36.7",
"세종특별자치시","85세이상","2020 년","3346","912","2434","37.5","3342","912","2430","37.5",
"세종특별자치시","85세이상","2021 년","3678","1028","2650","38.8","3668","1025","2643","38.8",
"세종특별자치시","85세이상","2022 년","3867","1080","2787","38.8","3860","1078","2782","38.7",
"세종특별자치시","85세이상","2023 년","4068","1161","2907","39.9","4060","1159","2901","40",
"세종특별자치시","평균연령","2015 년","36.5","35.7","37.4","","36.5","35.7","37.4","",
"세종특별자치시","평균연령","2016 년","36.1","35.4","36.9","","36.1","35.3","36.9","",
"세종특별자치시","평균연령","2017 년","36.1","35.5","36.8","","36.1","35.4","36.8","",
"세종특별자치시","평균연령","2018 년","36.2","35.6","36.9","","36.2","35.6","36.9","",
"세종특별자치시","평균연령","2019 년","36.5","35.9","37.1","","36.5","36","37.1","",
"세종특별자치시","평균연령","2020 년","36.9","36.3","37.4","","36.9","36.3","37.4","",
"세종특별자치시","평균연령","2021 년","37.4","36.9","37.9","","37.4","36.9","37.9","",
"세종특별자치시","평균연령","2022 년","37.7","37.2","38.3","","37.7","37.2","38.3","",
"세종특별자치시","평균연령","2023 년","38.2","37.7","38.8","","38.3","37.7","38.8","",
"세종특별자치시","중위연령","2015 년","36.5","36.2","36.9","","36.6","36.3","37","",
"세종특별자치시","중위연령","2016 년","36.4","36.1","36.7","","36.5","36.1","36.8","",
"세종특별자치시","중위연령","2017 년","36.7","36.4","37","","36.8","36.5","37","",
"세종특별자치시","중위연령","2018 년","37","36.8","37.3","","37.1","36.9","37.3","",
"세종특별자치시","중위연령","2019 년","37.5","37.2","37.7","","37.6","37.4","37.8","",
"세종특별자치시","중위연령","2020 년","38","37.7","38.3","","38.1","37.9","38.3","",
"세종특별자치시","중위연령","2021 년","38.7","38.5","39","","38.9","38.7","39","",
"세종특별자치시","중위연령","2022 년","39","38.6","39.4","","39.2","38.8","39.4","",
"세종특별자치시","중위연령","2023 년","39.6","39.2","40","","39.8","39.4","40.1","",
"경기도","합계","2015 년","12479061","6309661","6169400","102.3","12026429","6039800","5986629","100.9",
"경기도","합계","2016 년","12671956","6405301","6266655","102.2","12199257","6122936","6076321","100.8",
"경기도","합계","2017 년","12851601","6502723","6348878","102.4","12354512","6206756","6147756","101",
"경기도","합계","2018 년","13103188","6635106","6468082","102.6","12544991","6301846","6243145","100.9",
"경기도","합계","2019 년","13300900","6740448","6560452","102.7","12706105","6385194","6320911","101",
"경기도","합계","2020 년","13511676","6828367","6683309","102.2","12928214","6489718","6438496","100.8",
"경기도","합계","2021 년","13652529","6898723","6753806","102.1","13081325","6571118","6510207","100.9",
"경기도","합계","2022 년","13717827","6938563","6779264","102.3","13116902","6591993","6524909","101",
"경기도","합계","2023 년","13815367","6994451","6820916","102.5","13162788","6612985","6549803","101",
"경기도","0~4세","2015 년","608728","311848","296880","105","600260","307563","292697","105.1",
"경기도","0~4세","2016 년","603740","308993","294747","104.8","593820","303952","289868","104.9",
"경기도","0~4세","2017 년","578415","296246","282169","105","567564","290760","276804","105",
"경기도","0~4세","2018 년","563208","288581","274627","105.1","550307","281968","268339","105.1",
"경기도","0~4세","2019 년","538700","276443","262257","105.4","523378","268607","254771","105.4",
"경기도","0~4세","2020 년","501986","257213","244773","105.1","486921","249590","237331","105.2",
"경기도","0~4세","2021 년","466012","238704","227308","105","451883","231551","220332","105.1",
"경기도","0~4세","2022 년","438395","224396","213999","104.9","424657","217428","207229","104.9",
"경기도","0~4세","2023 년","413069","211452","201617","104.9","400506","205028","195478","104.9",
"경기도","5~9세","2015 년","624809","321590","303219","106.1","620260","319239","301021","106.1",
"경기도","5~9세","2016 년","638717","328388","310329","105.8","633075","325413","307662","105.8",
"경기도","5~9세","2017 년","642575","330241","312334","105.7","637092","327400","309692","105.7",
"경기도","5~9세","2018 년","643029","329984","313045","105.4","635978","326438","309540","105.5",
"경기도","5~9세","2019 년","648107","332102","316005","105.1","638841","327453","311388","105.2",
"경기도","5~9세","2020 년","652341","333805","318536","104.8","642465","328877","313588","104.9",
"경기도","5~9세","2021 년","644943","329755","315188","104.6","632772","323665","309107","104.7",
"경기도","5~9세","2022 년","614616","314267","300349","104.6","600919","307425","293494","104.7",
"경기도","5~9세","2023 년","585767","299837","285930","104.9","572751","293229","279522","104.9",
"경기도","10~14세","2015 년","645095","333421","311674","107","642563","332110","310453","107",
"경기도","10~14세","2016 년","619832","319827","300005","106.6","616887","318298","298589","106.6",
"경기도","10~14세","2017 년","620144","319076","301068","106","617392","317717","299675","106",
"경기도","10~14세","2018 년","625920","321256","304664","105.4","622001","319321","302680","105.5",
"경기도","10~14세","2019 년","624707","320316","304391","105.2","619547","317745","301802","105.3",
"경기도","10~14세","2020 년","640423","328666","311757","105.4","634804","325837","308967","105.5",
"경기도","10~14세","2021 년","656852","336690","320162","105.2","650140","333248","316892","105.2",
"경기도","10~14세","2022 년","660956","338640","322316","105.1","652793","334494","318299","105.1",
"경기도","10~14세","2023 년","655379","335369","320010","104.8","646447","330878","315569","104.9",
"경기도","15~19세","2015 년","791805","409613","382192","107.2","786755","406991","379764","107.2",
"경기도","15~19세","2016 년","774124","399498","374626","106.6","768556","396700","371856","106.7",
"경기도","15~19세","2017 년","741283","383053","358230","106.9","735505","380128","355377","107",
"경기도","15~19세","2018 년","711806","367865","343941","107","704181","363915","340266","107",
"경기도","15~19세","2019 년","684717","353116","331601","106.5","676519","349037","327482","106.6",
"경기도","15~19세","2020 년","654522","335837","318685","105.4","648335","332871","315464","105.5",
"경기도","15~19세","2021 년","624696","320223","304473","105.2","618523","317276","301247","105.3",
"경기도","15~19세","2022 년","625253","319929","305324","104.8","616045","315309","300736","104.8",
"경기도","15~19세","2023 년","630892","322841","308051","104.8","618804","316501","302303","104.7",
"경기도","20~24세","2015 년","841409","447814","393595","113.8","804648","424263","380385","111.5",
"경기도","20~24세","2016 년","850579","454093","396486","114.5","813226","429973","383253","112.2",
"경기도","20~24세","2017 년","849008","452960","396048","114.4","810977","428430","382547","112",
"경기도","20~24세","2018 년","847682","452265","395417","114.4","801875","422273","379602","111.2",
"경기도","20~24세","2019 년","834387","444948","389439","114.3","786388","413913","372475","111.1",
"경기도","20~24세","2020 년","847646","444969","402677","110.5","808894","421169","387725","108.6",
"경기도","20~24세","2021 년","820998","430376","390622","110.2","787648","411359","376289","109.3",
"경기도","20~24세","2022 년","776298","409774","366524","111.8","739484","388613","350871","110.8",
"경기도","20~24세","2023 년","740139","391489","348650","112.3","695712","364555","331157","110.1",
"경기도","25~29세","2015 년","807673","429154","378519","113.4","731217","379395","351822","107.8",
"경기도","25~29세","2016 년","834467","444835","389632","114.2","756646","393321","363325","108.3",
"경기도","25~29세","2017 년","876704","470526","406178","115.8","796839","417477","379362","110",
"경기도","25~29세","2018 년","919599","496998","422601","117.6","834485","439555","394930","111.3",
"경기도","25~29세","2019 년","953622","517879","435743","118.8","868553","460084","408469","112.6",
"경기도","25~29세","2020 년","980796","531660","449136","118.4","904805","481163","423642","113.6",
"경기도","25~29세","2021 년","988655","535522","453133","118.2","920787","491219","429568","114.4",
"경기도","25~29세","2022 년","978558","530901","447657","118.6","908543","484348","424195","114.2",
"경기도","25~29세","2023 년","967222","525598","441624","119","890257","473364","416893","113.5",
"경기도","30~34세","2015 년","974298","508729","465569","109.3","904071","462165","441906","104.6",
"경기도","30~34세","2016 년","939423","492343","447080","110.1","863963","442564","421399","105",
"경기도","30~34세","2017 년","906282","477664","428618","111.4","824632","424265","400367","106",
"경기도","30~34세","2018 년","899207","476558","422649","112.8","807838","416973","390865","106.7",
"경기도","30~34세","2019 년","906611","483344","423267","114.2","810656","420945","389711","108",
"경기도","30~34세","2020 년","919054","489226","429828","113.8","824564","429201","395363","108.6",
"경기도","30~34세","2021 년","944395","503662","440733","114.3","856307","448179","408128","109.8",
"경기도","30~34세","2022 년","979421","526297","453124","116.1","891285","469635","421650","111.4",
"경기도","30~34세","2023 년","1014680","549522","465158","118.1","920556","487347","433209","112.5",
"경기도","35~39세","2015 년","1045587","536301","509286","105.3","993964","502195","491769","102.1",
"경기도","35~39세","2016 년","1073515","551432","522083","105.6","1019400","515797","503603","102.4",
"경기도","35~39세","2017 년","1101844","568303","533541","106.5","1041924","529103","512821","103.2",
"경기도","35~39세","2018 년","1131739","585920","545819","107.3","1063315","541625","521690","103.8",
"경기도","35~39세","2019 년","1118336","582039","536297","108.5","1044396","534214","510182","104.7",
"경기도","35~39세","2020 년","1083739","564534","519205","108.7","1007461","516508","490953","105.2",
"경기도","35~39세","2021 년","1048051","547566","500485","109.4","969980","499139","470841","106",
"경기도","35~39세","2022 년","1002528","526009","476519","110.4","920405","474840","445565","106.6",
"경기도","35~39세","2023 년","979277","516066","463211","111.4","888943","459543","429400","107",
"경기도","40~44세","2015 년","1159219","592425","566794","104.5","1115735","565621","550114","102.8",
"경기도","40~44세","2016 년","1119278","572150","547128","104.6","1076513","545567","530946","102.8",
"경기도","40~44세","2017 년","1097795","560690","537105","104.4","1055120","534388","520732","102.6",
"경기도","40~44세","2018 년","1079663","553658","526005","105.3","1032478","524350","508128","103.2",
"경기도","40~44세","2019 년","1079145","554175","524970","105.6","1027063","521697","505366","103.2",
"경기도","40~44세","2020 년","1107785","568811","538974","105.5","1054406","535882","518524","103.3",
"경기도","40~44세","2021 년","1144257","588866","555391","106","1089476","555272","534204","103.9",
"경기도","40~44세","2022 년","1169885","603808","566077","106.7","1110353","567470","542883","104.5",
"경기도","40~44세","2023 년","1186574","614013","572561","107.2","1120845","574118","546727","105",
"경기도","45~49세","2015 년","1134981","574171","560810","102.4","1092241","550658","541583","101.7",
"경기도","45~49세","2016 년","1176250","592917","583333","101.6","1132327","568495","563832","100.8",
"경기도","45~49세","2017 년","1204113","610206","593907","102.7","1158126","584619","573507","101.9",
"경기도","45~49세","2018 년","1214041","616974","597067","103.3","1164537","589178","575359","102.4",
"경기도","45~49세","2019 년","1214187","619038","595149","104","1163248","589713","573535","102.8",
"경기도","45~49세","2020 년","1195611","608441","587170","103.6","1148173","581446","566727","102.6",
"경기도","45~49세","2021 년","1158611","590700","567911","104","1112873","564307","548566","102.9",
"경기도","45~49세","2022 년","1133292","577092","556200","103.8","1088275","551101","537174","102.6",
"경기도","45~49세","2023 년","1107103","565830","541273","104.5","1058878","537904","520974","103.2",
"경기도","50~54세","2015 년","1054682","540691","513991","105.2","1014137","520002","494135","105.2",
"경기도","50~54세","2016 년","1047131","537301","509830","105.4","1003764","515033","488731","105.4",
"경기도","50~54세","2017 년","1055583","537785","517798","103.9","1012005","515176","496829","103.7",
"경기도","50~54세","2018 년","1091113","551060","540053","102","1045208","526870","518338","101.6",
"경기도","50~54세","2019 년","1138512","572780","565732","101.2","1090769","547215","543554","100.7",
"경기도","50~54세","2020 년","1166575","585288","581287","100.7","1119026","560315","558711","100.3",
"경기도","50~54세","2021 년","1214132","608361","605771","100.4","1165738","582387","583351","99.8",
"경기도","50~54세","2022 년","1239256","624071","615185","101.4","1188331","596329","592002","100.7",
"경기도","50~54세","2023 년","1241361","626796","614565","102","1188471","597847","590624","101.2",
"경기도","55~59세","2015 년","900787","458719","442068","103.8","868366","442495","425871","103.9",
"경기도","55~59세","2016 년","971760","493228","478532","103.1","940329","477623","462706","103.2",
"경기도","55~59세","2017 년","1015993","516234","499759","103.3","983610","500165","483445","103.5",
"경기도","55~59세","2018 년","1056744","536539","520205","103.1","1016820","516779","500041","103.3",
"경기도","55~59세","2019 년","1073487","544882","528605","103.1","1029560","522724","506836","103.1",
"경기도","55~59세","2020 년","1079402","546744","532658","102.6","1033958","524219","509739","102.8",
"경기도","55~59세","2021 년","1071438","544215","527223","103.2","1023745","520151","503594","103.3",
"경기도","55~59세","2022 년","1077464","543707","533757","101.9","1029877","519609","510268","101.8",
"경기도","55~59세","2023 년","1106313","554232","552081","100.4","1058782","529836","528946","100.2",
"경기도","60~64세","2015 년","588180","292108","296072","98.7","566514","281170","285344","98.5",
"경기도","60~64세","2016 년","663883","330267","333616","99","639097","317802","321295","98.9",
"경기도","60~64세","2017 년","716151","357073","359078","99.4","688022","343033","344989","99.4",
"경기도","60~64세","2018 년","789566","394929","394637","100.1","758875","379729","379146","100.2",
"경기도","60~64세","2019 년","856522","428906","427616","100.3","824209","412981","411228","100.4",
"경기도","60~64세","2020 년","923711","462472","461239","100.3","888503","445476","443027","100.6",
"경기도","60~64세","2021 년","994733","497454","497279","100","961570","481524","480046","100.3",
"경기도","60~64세","2022 년","1030808","515715","515093","100.1","995641","498892","496749","100.4",
"경기도","60~64세","2023 년","1064833","533223","531610","100.3","1024710","513956","510754","100.6",
"경기도","65~69세","2015 년","429423","205630","223793","91.9","420257","201180","219077","91.8",
"경기도","65~69세","2016 년","440781","211582","229199","92.3","430447","206599","223848","92.3",
"경기도","65~69세","2017 년","470087","227286","242801","93.6","457905","221459","236446","93.7",
"경기도","65~69세","2018 년","493540","239025","254515","93.9","479507","232391","247116","94",
"경기도","65~69세","2019 년","531844","258300","273544","94.4","515623","250655","264968","94.6",
"경기도","65~69세","2020 년","599220","291342","307878","94.6","579930","282391","297539","94.9",
"경기도","65~69세","2021 년","670633","326755","343878","95","649907","317073","332834","95.3",
"경기도","65~69세","2022 년","718836","350895","367941","95.4","695009","339724","355285","95.6",
"경기도","65~69세","2023 년","785264","384866","400398","96.1","759672","372954","386718","96.4",
"경기도","70~74세","2015 년","347906","156470","191436","81.7","344742","155115","189627","81.8",
"경기도","70~74세","2016 년","352010","159523","192487","82.9","348702","158178","190524","83",
"경기도","70~74세","2017 년","361783","165414","196369","84.2","357975","163886","194089","84.4",
"경기도","70~74세","2018 년","382794","176951","205843","86","378409","175157","203252","86.2",
"경기도","70~74세","2019 년","405474","189352","216122","87.6","399915","186982","212933","87.8",
"경기도","70~74세","2020 년","427729","199991","227738","87.8","420576","197002","223574","88.1",
"경기도","70~74세","2021 년","437113","204609","232504","88","428985","201174","227811","88.3",
"경기도","70~74세","2022 년","463738","218274","245464","88.9","453905","214093","239812","89.3",
"경기도","70~74세","2023 년","483654","228015","255639","89.2","472138","223210","248928","89.7",
"경기도","75~79세","2015 년","263603","108863","154740","70.4","261492","108093","153399","70.5",
"경기도","75~79세","2016 년","279663","116975","162688","71.9","277523","116245","161278","72.1",
"경기도","75~79세","2017 년","304187","128798","175389","73.4","301957","128080","173877","73.7",
"경기도","75~79세","2018 년","316153","134673","181480","74.2","313834","133966","179868","74.5",
"경기도","75~79세","2019 년","323247","138510","184737","75","320620","137648","182972","75.2",
"경기도","75~79세","2020 년","331533","143197","188336","76","328604","142275","186329","76.4",
"경기도","75~79세","2021 년","335499","146234","189265","77.3","332463","145286","187177","77.6",
"경기도","75~79세","2022 년","344225","151369","192856","78.5","340481","150121","190360","78.9",
"경기도","75~79세","2023 년","362449","161089","201360","80","357984","159546","198438","80.4",
"경기도","80~84세","2015 년","155782","54574","101208","53.9","154755","54219","100536","53.9",
"경기도","80~84세","2016 년","172937","61754","111183","55.5","171786","61383","110403","55.6",
"경기도","80~84세","2017 년","185880","67803","118077","57.4","184672","67456","117216","57.5",
"경기도","80~84세","2018 년","201839","74832","127007","58.9","200422","74450","125972","59.1",
"경기도","80~84세","2019 년","218192","82160","136032","60.4","216629","81691","134938","60.5",
"경기도","80~84세","2020 년","230254","88134","142120","62","228357","87649","140708","62.3",
"경기도","80~84세","2021 년","244882","95085","149797","63.5","242920","94574","148346","63.8",
"경기도","80~84세","2022 년","266151","104878","161273","65","263960","104300","159660","65.3",
"경기도","80~84세","2023 년","276152","109542","166610","65.7","273590","108873","164717","66.1",
"경기도","85~89세","2015 년","73145","19894","53251","37.4","72728","19755","52973","37.3",
"경기도","85~89세","2016 년","79459","22169","57290","38.7","79010","22039","56971","38.7",
"경기도","85~89세","2017 년","86400","24803","61597","40.3","85947","24684","61263","40.3",
"경기도","85~89세","2018 년","94115","27654","66461","41.6","93617","27550","66067","41.7",
"경기도","85~89세","2019 년","104068","31406","72662","43.2","103440","31223","72217","43.2",
"경기도","85~89세","2020 년","116857","36118","80739","44.7","116151","35969","80182","44.9",
"경기도","85~89세","2021 년","129493","40906","88587","46.2","128722","40731","87991","46.3",
"경기도","85~89세","2022 년","137918","44590","93328","47.8","136993","44365","92628","47.9",
"경기도","85~89세","2023 년","149502","49175","100327","49","148361","48881","99480","49.1",
"경기도","90~94세","2015 년","25981","6377","19604","32.5","25813","6326","19487","32.5",
"경기도","90~94세","2016 년","27510","6527","20983","31.1","27335","6475","20860","31",
"경기도","90~94세","2017 년","29427","6804","22623","30.1","29325","6780","22545","30.1",
"경기도","90~94세","2018 년","32367","7338","25029","29.3","32263","7315","24948","29.3",
"경기도","90~94세","2019 년","37290","8581","28709","29.9","37091","8526","28565","29.8",
"경기도","90~94세","2020 년","41752","9687","32065","30.2","41579","9654","31925","30.2",
"경기도","90~94세","2021 년","45383","10738","34645","31","45182","10710","34472","31.1",
"경기도","90~94세","2022 년","48181","11675","36506","32","47938","11630","36308","32",
"경기도","90~94세","2023 년","52345","12999","39346","33","52039","12929","39110","33.1",
"경기도","95~99세","2015 년","5252","1155","4097","28.2","5210","1138","4072","27.9",
"경기도","95~99세","2016 년","6091","1373","4718","29.1","6060","1362","4698","29",
"경기도","95~99세","2017 년","7048","1621","5427","29.9","7031","1617","5414","29.9",
"경기도","95~99세","2018 년","8070","1891","6179","30.6","8051","1889","6162","30.7",
"경기도","95~99세","2019 년","8600","1948","6652","29.3","8522","1922","6600","29.1",
"경기도","95~99세","2020 년","9426","1986","7440","26.7","9394","1980","7414","26.7",
"경기도","95~99세","2021 년","10191","2013","8178","24.6","10148","2006","8142","24.6",
"경기도","95~99세","2022 년","10426","1967","8459","23.3","10392","1959","8433","23.2",
"경기도","95~99세","2023 년","11644","2129","9515","22.4","11605","2121","9484","22.4",
"경기도","100세이상","2015 년","716","114","602","18.9","701","107","594","18",
"경기도","100세이상","2016 년","806","126","680","18.5","791","117","674","17.4",
"경기도","100세이상","2017 년","899","137","762","18","892","133","759","17.5",
"경기도","100세이상","2018 년","993","155","838","18.5","990","154","836","18.4",
"경기도","100세이상","2019 년","1145","223","922","24.2","1138","219","919","23.8",
"경기도","100세이상","2020 년","1314","246","1068","23","1308","244","1064","22.9",
"경기도","100세이상","2021 년","1562","289","1273","22.7","1556","287","1269","22.6",
"경기도","100세이상","2022 년","1622","309","1313","23.5","1616","308","1308","23.5",
"경기도","100세이상","2023 년","1748","368","1380","26.7","1737","365","1372","26.6",
"경기도","15세미만","2015 년","1878632","966859","911773","106","1863083","958912","904171","106.1",
"경기도","15세미만","2016 년","1862289","957208","905081","105.8","1843782","947663","896119","105.8",
"경기도","15세미만","2017 년","1841134","945563","895571","105.6","1822048","935877","886171","105.6",
"경기도","15세미만","2018 년","1832157","939821","892336","105.3","1808286","927727","880559","105.4",
"경기도","15세미만","2019 년","1811514","928861","882653","105.2","1781766","913805","867961","105.3",
"경기도","15세미만","2020 년","1794750","919684","875066","105.1","1764190","904304","859886","105.2",
"경기도","15세미만","2021 년","1767807","905149","862658","104.9","1734795","888464","846331","105",
"경기도","15세미만","2022 년","1713967","877303","836664","104.9","1678369","859347","819022","104.9",
"경기도","15세미만","2023 년","1654215","846658","807557","104.8","1619704","829135","790569","104.9",
"경기도","15~64세","2015 년","9298621","4789725","4508896","106.2","8877648","4534955","4342693","104.4",
"경기도","15~64세","2016 년","9450410","4868064","4582346","106.2","9013821","4602875","4410946","104.4",
"경기도","15~64세","2017 년","9564756","4934494","4630262","106.6","9106760","4656784","4449976","104.6",
"경기도","15~64세","2018 년","9741160","5032766","4708394","106.9","9229612","4721247","4508365","104.7",
"경기도","15~64세","2019 년","9859526","5101107","4758419","107.2","9321361","4772523","4548838","104.9",
"경기도","15~64세","2020 년","9958841","5137982","4820859","106.6","9438125","4828250","4609875","104.7",
"경기도","15~64세","2021 년","10009966","5166945","4843021","106.7","9506647","4870813","4635834","105.1",
"경기도","15~64세","2022 년","10012763","5177303","4835460","107.1","9488239","4866146","4622093","105.3",
"경기도","15~64세","2023 년","10038394","5199610","4838784","107.5","9465958","4854971","4610987","105.3",
"경기도","65세이상","2015 년","1301808","553077","748731","73.9","1285698","545933","739765","73.8",
"경기도","65세이상","2016 년","1359257","580029","779228","74.4","1341654","572398","769256","74.4",
"경기도","65세이상","2017 년","1445711","622666","823045","75.7","1425704","614095","811609","75.7",
"경기도","65세이상","2018 년","1529871","662519","867352","76.4","1507093","652872","854221","76.4",
"경기도","65세이상","2019 년","1629860","710480","919380","77.3","1602978","698866","904112","77.3",
"경기도","65세이상","2020 년","1758085","770701","987384","78.1","1725899","757164","968735","78.2",
"경기도","65세이상","2021 년","1874756","826629","1048127","78.9","1839883","811841","1028042","79",
"경기도","65세이상","2022 년","1991097","883957","1107140","79.8","1950294","866500","1083794","80",
"경기도","65세이상","2023 년","2122758","948183","1174575","80.7","2077126","928879","1148247","80.9",
"경기도","85세이상","2015 년","105094","27540","77554","35.5","104452","27326","77126","35.4",
"경기도","85세이상","2016 년","113866","30195","83671","36.1","113196","29993","83203","36",
"경기도","85세이상","2017 년","123774","33365","90409","36.9","123195","33214","89981","36.9",
"경기도","85세이상","2018 년","135545","37038","98507","37.6","134921","36908","98013","37.7",
"경기도","85세이상","2019 년","151103","42158","108945","38.7","150191","41890","108301","38.7",
"경기도","85세이상","2020 년","169349","48037","121312","39.6","168432","47847","120585","39.7",
"경기도","85세이상","2021 년","186629","53946","132683","40.7","185608","53734","131874","40.7",
"경기도","85세이상","2022 년","198147","58541","139606","41.9","196939","58262","138677","42",
"경기도","85세이상","2023 년","215239","64671","150568","43","213742","64296","149446","43",
"경기도","평균연령","2015 년","38.8","37.9","39.7","","38.8","37.9","39.7","",
"경기도","평균연령","2016 년","39.3","38.4","40.2","","39.3","38.4","40.2","",
"경기도","평균연령","2017 년","39.8","38.9","40.7","","39.8","38.9","40.7","",
"경기도","평균연령","2018 년","40.3","39.3","41.2","","40.3","39.4","41.2","",
"경기도","평균연령","2019 년","40.8","39.9","41.8","","40.9","40","41.8","",
"경기도","평균연령","2020 년","41.3","40.4","42.3","","41.4","40.5","42.3","",
"경기도","평균연령","2021 년","41.9","40.9","42.8","","41.9","41","42.9","",
"경기도","평균연령","2022 년","42.4","41.5","43.4","","42.5","41.6","43.5","",
"경기도","평균연령","2023 년","43","42","44","","43.1","42.2","44.1","",
"경기도","중위연령","2015 년","39.5","38.6","40.4","","39.6","38.8","40.4","",
"경기도","중위연령","2016 년","40","39.1","41","","40.2","39.4","41","",
"경기도","중위연령","2017 년","40.5","39.6","41.5","","40.7","39.9","41.6","",
"경기도","중위연령","2018 년","41","40","42.1","","41.3","40.4","42.2","",
"경기도","중위연령","2019 년","41.5","40.5","42.7","","41.9","40.9","42.8","",
"경기도","중위연령","2020 년","42","41","43.2","","42.3","41.4","43.3","",
"경기도","중위연령","2021 년","42.6","41.7","43.8","","42.9","42","43.9","",
"경기도","중위연령","2022 년","43.2","42.2","44.4","","43.5","42.6","44.6","",
"경기도","중위연령","2023 년","43.9","42.8","45","","44.2","43.3","45.2","",
"강원특별자치도","합계","2015 년","1518040","768241","749799","102.5","1499734","758601","741133","102.4",
"강원특별자치도","합계","2016 년","1521751","769461","752290","102.3","1502387","759122","743265","102.1",
"강원특별자치도","합계","2017 년","1521386","769043","752343","102.2","1500390","757764","742626","102",
"강원특별자치도","합계","2018 년","1520391","768604","751787","102.2","1496242","755527","740715","102",
"강원특별자치도","합계","2019 년","1520127","767717","752410","102","1493119","753098","740021","101.8",
"강원특별자치도","합계","2020 년","1521763","767674","754089","101.8","1497109","754831","742278","101.7",
"강원특별자치도","합계","2021 년","1521890","767067","754823","101.6","1497308","754354","742954","101.5",
"강원특별자치도","합계","2022 년","1528037","770518","757519","101.7","1500404","755752","744652","101.5",
"강원특별자치도","합계","2023 년","1528014","770824","757190","101.8","1494874","752636","742238","101.4",
"강원특별자치도","0~4세","2015 년","58045","29681","28364","104.6","57864","29581","28283","104.6",
"강원특별자치도","0~4세","2016 년","56307","28676","27631","103.8","56153","28592","27561","103.7",
"강원특별자치도","0~4세","2017 년","52755","26958","25797","104.5","52636","26893","25743","104.5",
"강원특별자치도","0~4세","2018 년","50189","25640","24549","104.4","50042","25567","24475","104.5",
"강원특별자치도","0~4세","2019 년","47941","24485","23456","104.4","47717","24373","23344","104.4",
"강원특별자치도","0~4세","2020 년","45588","23331","22257","104.8","45372","23226","22146","104.9",
"강원특별자치도","0~4세","2021 년","42754","21836","20918","104.4","42558","21732","20826","104.4",
"강원특별자치도","0~4세","2022 년","40923","20892","20031","104.3","40696","20773","19923","104.3",
"강원특별자치도","0~4세","2023 년","38785","19768","19017","103.9","38561","19650","18911","103.9",
"강원특별자치도","5~9세","2015 년","63331","32755","30576","107.1","63160","32678","30482","107.2",
"강원특별자치도","5~9세","2016 년","63701","32878","30823","106.7","63520","32790","30730","106.7",
"강원특별자치도","5~9세","2017 년","62989","32368","30621","105.7","62903","32332","30571","105.8",
"강원특별자치도","5~9세","2018 년","61506","31536","29970","105.2","61403","31487","29916","105.3",
"강원특별자치도","5~9세","2019 년","60559","31058","29501","105.3","60404","30980","29424","105.3",
"강원특별자치도","5~9세","2020 년","59507","30432","29075","104.7","59355","30353","29002","104.7",
"강원특별자치도","5~9세","2021 년","57870","29586","28284","104.6","57686","29494","28192","104.6",
"강원특별자치도","5~9세","2022 년","54717","28071","26646","105.3","54492","27958","26534","105.4",
"강원특별자치도","5~9세","2023 년","51697","26508","25189","105.2","51525","26425","25100","105.3",
"강원특별자치도","10~14세","2015 년","72393","37782","34611","109.2","72288","37729","34559","109.2",
"강원특별자치도","10~14세","2016 년","67581","35129","32452","108.2","67469","35073","32396","108.3",
"강원특별자치도","10~14세","2017 년","65912","34317","31595","108.6","65841","34285","31556","108.6",
"강원특별자치도","10~14세","2018 년","64623","33589","31034","108.2","64521","33540","30981","108.3",
"강원특별자치도","10~14세","2019 년","63115","32744","30371","107.8","62983","32681","30302","107.9",
"강원특별자치도","10~14세","2020 년","63319","32728","30591","107","63225","32688","30537","107",
"강원특별자치도","10~14세","2021 년","63908","33071","30837","107.2","63792","33010","30782","107.2",
"강원특별자치도","10~14세","2022 년","63495","32734","30761","106.4","63366","32660","30706","106.4",
"강원특별자치도","10~14세","2023 년","61991","31977","30014","106.5","61863","31909","29954","106.5",
"강원특별자치도","15~19세","2015 년","97756","52068","45688","114","97302","51874","45428","114.2",
"강원특별자치도","15~19세","2016 년","94329","50246","44083","114","93835","50012","43823","114.1",
"강원특별자치도","15~19세","2017 년","89850","47915","41935","114.3","89224","47592","41632","114.3",
"강원특별자치도","15~19세","2018 년","85220","45359","39861","113.8","84452","44940","39512","113.7",
"강원특별자치도","15~19세","2019 년","79998","42385","37613","112.7","79303","42048","37255","112.9",
"강원특별자치도","15~19세","2020 년","72734","38538","34196","112.7","72366","38340","34026","112.7",
"강원특별자치도","15~19세","2021 년","68221","35983","32238","111.6","67808","35747","32061","111.5",
"강원특별자치도","15~19세","2022 년","67850","35912","31938","112.4","67146","35524","31622","112.3",
"강원특별자치도","15~19세","2023 년","67019","35176","31843","110.5","66029","34654","31375","110.5",
"강원특별자치도","20~24세","2015 년","107921","62790","45131","139.1","104816","61228","43588","140.5",
"강원특별자치도","20~24세","2016 년","109384","62987","46397","135.8","105907","61068","44839","136.2",
"강원특별자치도","20~24세","2017 년","107260","61508","45752","134.4","103149","59138","44011","134.4",
"강원특별자치도","20~24세","2018 년","105492","60397","45095","133.9","100643","57582","43061","133.7",
"강원특별자치도","20~24세","2019 년","102735","58406","44329","131.8","97721","55459","42262","131.2",
"강원특별자치도","20~24세","2020 년","99186","56128","43058","130.4","95232","53877","41355","130.3",
"강원특별자치도","20~24세","2021 년","94687","53523","41164","130","91223","51620","39603","130.3",
"강원특별자치도","20~24세","2022 년","91657","51836","39821","130.2","87750","49611","38139","130.1",
"강원특별자치도","20~24세","2023 년","87432","49414","38018","130","82793","46701","36092","129.4",
"강원특별자치도","25~29세","2015 년","80314","45570","34744","131.2","76777","43659","33118","131.8",
"강원특별자치도","25~29세","2016 년","82158","46644","35514","131.3","78496","44637","33859","131.8",
"강원특별자치도","25~29세","2017 년","84879","48381","36498","132.6","81027","46216","34811","132.8",
"강원특별자치도","25~29세","2018 년","86744","49825","36919","135","82242","47198","35044","134.7",
"강원특별자치도","25~29세","2019 년","87962","50362","37600","133.9","82877","47444","35433","133.9",
"강원특별자치도","25~29세","2020 년","89166","51128","38038","134.4","84339","48375","35964","134.5",
"강원특별자치도","25~29세","2021 년","89340","51264","38076","134.6","84751","48619","36132","134.6",
"강원특별자치도","25~29세","2022 년","89638","51288","38350","133.7","84742","48393","36349","133.1",
"강원특별자치도","25~29세","2023 년","89090","50911","38179","133.3","83323","47469","35854","132.4",
"강원특별자치도","30~34세","2015 년","88552","46803","41749","112.1","85868","45229","40639","111.3",
"강원특별자치도","30~34세","2016 년","84544","45018","39526","113.9","81620","43336","38284","113.2",
"강원특별자치도","30~34세","2017 년","79689","42731","36958","115.6","76594","40984","35610","115.1",
"강원특별자치도","30~34세","2018 년","76859","41343","35516","116.4","73190","39284","33906","115.9",
"강원특별자치도","30~34세","2019 년","76364","41162","35202","116.9","72207","38835","33372","116.4",
"강원특별자치도","30~34세","2020 년","76486","41298","35188","117.4","72513","39128","33385","117.2",
"강원특별자치도","30~34세","2021 년","77596","41847","35749","117.1","73709","39782","33927","117.3",
"강원특별자치도","30~34세","2022 년","81227","44130","37097","119","76667","41553","35114","118.3",
"강원특별자치도","30~34세","2023 년","84252","46274","37978","121.8","78642","42920","35722","120.2",
"강원특별자치도","35~39세","2015 년","97761","49940","47821","104.4","95961","48805","47156","103.5",
"강원특별자치도","35~39세","2016 년","98366","50256","48110","104.5","96444","49084","47360","103.6",
"강원특별자치도","35~39세","2017 년","98679","50391","48288","104.4","96458","49092","47366","103.6",
"강원특별자치도","35~39세","2018 년","98178","50306","47872","105.1","95467","48778","46689","104.5",
"강원특별자치도","35~39세","2019 년","95332","49118","46214","106.3","92272","47417","44855","105.7",
"강원특별자치도","35~39세","2020 년","90838","47094","43744","107.7","87830","45489","42341","107.4",
"강원특별자치도","35~39세","2021 년","86696","45071","41625","108.3","83438","43308","40130","107.9",
"강원특별자치도","35~39세","2022 년","82413","43163","39250","110","78664","41042","37622","109.1",
"강원특별자치도","35~39세","2023 년","79752","42120","37632","111.9","75102","39465","35637","110.7",
"강원특별자치도","40~44세","2015 년","117324","60850","56474","107.7","115845","59984","55861","107.4",
"강원특별자치도","40~44세","2016 년","111842","57895","53947","107.3","110354","57039","53315","107",
"강원특별자치도","40~44세","2017 년","108105","55547","52558","105.7","106571","54692","51879","105.4",
"강원특별자치도","40~44세","2018 년","103412","52901","50511","104.7","101603","51922","49681","104.5",
"강원특별자치도","40~44세","2019 년","99749","50936","48813","104.3","97651","49806","47845","104.1",
"강원특별자치도","40~44세","2020 년","100087","50766","49321","102.9","98019","49700","48319","102.9",
"강원특별자치도","40~44세","2021 년","101110","51349","49761","103.2","98881","50189","48692","103.1",
"강원특별자치도","40~44세","2022 년","102610","52063","50547","103","99991","50668","49323","102.7",
"강원특별자치도","40~44세","2023 년","102435","52198","50237","103.9","99046","50328","48718","103.3",
"강원특별자치도","45~49세","2015 년","124735","65031","59704","108.9","123391","64405","58986","109.2",
"강원특별자치도","45~49세","2016 년","126043","65377","60666","107.8","124660","64720","59940","108",
"강원특별자치도","45~49세","2017 년","125915","65585","60330","108.7","124393","64849","59544","108.9",
"강원특별자치도","45~49세","2018 년","123948","64550","59398","108.7","122288","63742","58546","108.9",
"강원특별자치도","45~49세","2019 년","122187","63420","58767","107.9","120356","62511","57845","108.1",
"강원특별자치도","45~49세","2020 년","118985","61442","57543","106.8","117348","60692","56656","107.1",
"강원특별자치도","45~49세","2021 년","113419","58337","55082","105.9","111785","57564","54221","106.2",
"강원특별자치도","45~49세","2022 년","110161","56316","53845","104.6","108446","55487","52959","104.8",
"강원특별자치도","45~49세","2023 년","105658","53784","51874","103.7","103610","52765","50845","103.8",
"강원특별자치도","50~54세","2015 년","128399","65544","62855","104.3","127255","65071","62184","104.6",
"강원특별자치도","50~54세","2016 년","123781","63750","60031","106.2","122535","63234","59301","106.6",
"강원특별자치도","50~54세","2017 년","121263","62397","58866","106","119940","61849","58091","106.5",
"강원특별자치도","50~54세","2018 년","122446","63047","59399","106.1","121053","62461","58592","106.6",
"강원특별자치도","50~54세","2019 년","125605","64518","61087","105.6","123945","63753","60192","105.9",
"강원특별자치도","50~54세","2020 년","128191","66334","61857","107.2","126700","65717","60983","107.8",
"강원특별자치도","50~54세","2021 년","130156","66998","63158","106.1","128585","66342","62243","106.6",
"강원특별자치도","50~54세","2022 년","130218","67343","62875","107.1","128621","66669","61952","107.6",
"강원특별자치도","50~54세","2023 년","128042","66110","61932","106.7","126312","65332","60980","107.1",
"강원특별자치도","55~59세","2015 년","131865","66279","65586","101.1","130933","65871","65062","101.2",
"강원특별자치도","55~59세","2016 년","138849","69577","69272","100.4","137941","69177","68764","100.6",
"강원특별자치도","55~59세","2017 년","140558","70338","70220","100.2","139603","69933","69670","100.4",
"강원특별자치도","55~59세","2018 년","139915","70108","69807","100.4","138897","69679","69218","100.7",
"강원특별자치도","55~59세","2019 년","137387","69326","68061","101.9","136177","68781","67396","102.1",
"강원특별자치도","55~59세","2020 년","132525","66983","65542","102.2","131358","66517","64841","102.6",
"강원특별자치도","55~59세","2021 년","127653","65062","62591","103.9","126424","64578","61846","104.4",
"강원특별자치도","55~59세","2022 년","126085","64070","62015","103.3","124788","63560","61228","103.8",
"강원특별자치도","55~59세","2023 년","127742","64918","62824","103.3","126284","64324","61960","103.8",
"강원특별자치도","60~64세","2015 년","94841","47060","47781","98.5","94186","46743","47443","98.5",
"강원특별자치도","60~64세","2016 년","106474","53218","53256","99.9","105785","52882","52903","100",
"강원특별자치도","60~64세","2017 년","112039","56432","55607","101.5","111303","56075","55228","101.5",
"강원특별자치도","60~64세","2018 년","121823","61442","60381","101.8","121149","61125","60024","101.8",
"강원특별자치도","60~64세","2019 년","128720","64683","64037","101","127907","64303","63604","101.1",
"강원특별자치도","60~64세","2020 년","136174","68011","68163","99.8","135320","67645","67675","100",
"강원특별자치도","60~64세","2021 년","144351","71862","72489","99.1","143464","71476","71988","99.3",
"강원특별자치도","60~64세","2022 년","146001","72525","73476","98.7","145081","72142","72939","98.9",
"강원특별자치도","60~64세","2023 년","146195","72849","73346","99.3","145129","72404","72725","99.6",
"강원특별자치도","65~69세","2015 년","70359","33441","36918","90.6","70015","33267","36748","90.5",
"강원특별자치도","65~69세","2016 년","69592","33055","36537","90.5","69228","32888","36340","90.5",
"강원특별자치도","65~69세","2017 년","75253","35940","39313","91.4","74860","35752","39108","91.4",
"강원특별자치도","65~69세","2018 년","77594","37366","40228","92.9","77199","37191","40008","93",
"강원특별자치도","65~69세","2019 년","84543","41131","43412","94.7","84095","40916","43179","94.8",
"강원특별자치도","65~69세","2020 년","96073","47290","48783","96.9","95640","47083","48557","97",
"강원특별자치도","65~69세","2021 년","107667","53490","54177","98.7","107175","53264","53911","98.8",
"강원특별자치도","65~69세","2022 년","113929","57050","56879","100.3","113367","56790","56577","100.4",
"강원특별자치도","65~69세","2023 년","123788","62020","61768","100.4","123149","61733","61416","100.5",
"강원특별자치도","70~74세","2015 년","71145","31766","39379","80.7","70961","31683","39278","80.7",
"강원특별자치도","70~74세","2016 년","68911","31046","37865","82","68721","30946","37775","81.9",
"강원특별자치도","70~74세","2017 년","67980","31015","36965","83.9","67806","30930","36876","83.9",
"강원특별자치도","70~74세","2018 년","68572","31587","36985","85.4","68413","31503","36910","85.4",
"강원특별자치도","70~74세","2019 년","68564","32083","36481","87.9","68360","31984","36376","87.9",
"강원특별자치도","70~74세","2020 년","68023","31744","36279","87.5","67813","31650","36163","87.5",
"강원특별자치도","70~74세","2021 년","67455","31430","36025","87.2","67234","31342","35892","87.3",
"강원특별자치도","70~74세","2022 년","73382","34395","38987","88.2","73126","34287","38839","88.3",
"강원특별자치도","70~74세","2023 년","76123","36016","40107","89.8","75798","35883","39915","89.9",
"강원특별자치도","75~79세","2015 년","58332","24329","34003","71.5","58237","24280","33957","71.5",
"강원특별자치도","75~79세","2016 년","60715","25390","35325","71.9","60625","25352","35273","71.9",
"강원특별자치도","75~79세","2017 년","64184","26881","37303","72.1","64089","26843","37246","72.1",
"강원특별자치도","75~79세","2018 년","64655","27142","37513","72.4","64557","27097","37460","72.3",
"강원특별자치도","75~79세","2019 년","64630","27293","37337","73.1","64515","27241","37274","73.1",
"강원특별자치도","75~79세","2020 년","64713","27602","37111","74.4","64601","27557","37044","74.4",
"강원특별자치도","75~79세","2021 년","63132","27270","35862","76","63016","27224","35792","76.1",
"강원특별자치도","75~79세","2022 년","62529","27520","35009","78.6","62384","27458","34926","78.6",
"강원특별자치도","75~79세","2023 년","63244","28156","35088","80.2","63087","28094","34993","80.3",
"강원특별자치도","80~84세","2015 년","31914","10548","21366","49.4","31860","10525","21335","49.3",
"강원특별자치도","80~84세","2016 년","34842","12020","22822","52.7","34797","12005","22792","52.7",
"강원특별자치도","80~84세","2017 년","38061","13632","24429","55.8","38005","13609","24396","55.8",
"강원특별자치도","80~84세","2018 년","41514","15260","26254","58.1","41455","15235","26220","58.1",
"강원특별자치도","80~84세","2019 년","44795","16822","27973","60.1","44740","16803","27937","60.1",
"강원특별자치도","80~84세","2020 년","47478","18146","29332","61.9","47425","18124","29301","61.9",
"강원특별자치도","80~84세","2021 년","49981","19196","30785","62.4","49922","19178","30744","62.4",
"강원특별자치도","80~84세","2022 년","53075","20433","32642","62.6","52996","20410","32586","62.6",
"강원특별자치도","80~84세","2023 년","53604","20724","32880","63","53517","20698","32819","63.1",
"강원특별자치도","85~89세","2015 년","16004","4120","11884","34.7","15980","4110","11870","34.6",
"강원특별자치도","85~89세","2016 년","16772","4375","12397","35.3","16755","4368","12387","35.3",
"강원특별자치도","85~89세","2017 년","17753","4699","13054","36","17741","4696","13045","36",
"강원특별자치도","85~89세","2018 년","18843","5151","13692","37.6","18820","5144","13676","37.6",
"강원특별자치도","85~89세","2019 년","20161","5609","14552","38.5","20126","5593","14533","38.5",
"강원특별자치도","85~89세","2020 년","21950","6342","15608","40.6","21924","6335","15589","40.6",
"강원특별자치도","85~89세","2021 년","24424","7402","17022","43.5","24396","7397","16999","43.5",
"강원특별자치도","85~89세","2022 년","26267","8224","18043","45.6","26239","8216","18023","45.6",
"강원특별자치도","85~89세","2023 년","28702","9181","19521","47","28661","9167","19494","47",
"강원특별자치도","90~94세","2015 년","5761","1573","4188","37.6","5753","1571","4182","37.6",
"강원특별자치도","90~94세","2016 년","6106","1606","4500","35.7","6096","1603","4493","35.7",
"강원특별자치도","90~94세","2017 년","6596","1628","4968","32.8","6590","1626","4964","32.8",
"강원특별자치도","90~94세","2018 년","6971","1589","5382","29.5","6966","1587","5379","29.5",
"강원특별자치도","90~94세","2019 년","7729","1678","6051","27.7","7721","1674","6047","27.7",
"강원특별자치도","90~94세","2020 년","8481","1788","6693","26.7","8472","1786","6686","26.7",
"강원특별자치도","90~94세","2021 년","9001","1956","7045","27.8","8995","1954","7041","27.8",
"강원특별자치도","90~94세","2022 년","9282","2029","7253","28","9268","2027","7241","28",
"강원특별자치도","90~94세","2023 년","9766","2239","7527","29.7","9751","2236","7515","29.8",
"강원특별자치도","95~99세","2015 년","1159","285","874","32.6","1153","282","871","32.4",
"강원특별자치도","95~99세","2016 년","1296","289","1007","28.7","1288","287","1001","28.7",
"강원특별자치도","95~99세","2017 년","1477","348","1129","30.8","1468","346","1122","30.8",
"강원특별자치도","95~99세","2018 년","1687","430","1257","34.2","1682","429","1253","34.2",
"강원특별자치도","95~99세","2019 년","1805","448","1357","33","1797","447","1350","33.1",
"강원특별자치도","95~99세","2020 년","2005","506","1499","33.8","2003","506","1497","33.8",
"강원특별자치도","95~99세","2021 년","2139","469","1670","28.1","2136","469","1667","28.1",
"강원특별자치도","95~99세","2022 년","2254","464","1790","25.9","2252","464","1788","26",
"강원특별자치도","95~99세","2023 년","2343","395","1948","20.3","2339","393","1946","20.2",
"강원특별자치도","100세이상","2015 년","129","26","103","25.2","129","26","103","25.2",
"강원특별자치도","100세이상","2016 년","158","29","129","22.5","158","29","129","22.5",
"강원특별자치도","100세이상","2017 년","189","32","157","20.4","189","32","157","20.4",
"강원특별자치도","100세이상","2018 년","200","36","164","22","200","36","164","22",
"강원특별자치도","100세이상","2019 년","246","50","196","25.5","245","49","196","25",
"강원특별자치도","100세이상","2020 년","254","43","211","20.4","254","43","211","20.4",
"강원특별자치도","100세이상","2021 년","330","65","265","24.5","330","65","265","24.5",
"강원특별자치도","100세이상","2022 년","324","60","264","22.7","322","60","262","22.9",
"강원특별자치도","100세이상","2023 년","354","86","268","32.1","353","86","267","32.2",
"강원특별자치도","15세미만","2015 년","193769","100218","93551","107.1","193312","99988","93324","107.1",
"강원특별자치도","15세미만","2016 년","187589","96683","90906","106.4","187142","96455","90687","106.4",
"강원특별자치도","15세미만","2017 년","181656","93643","88013","106.4","181380","93510","87870","106.4",
"강원특별자치도","15세미만","2018 년","176318","90765","85553","106.1","175966","90594","85372","106.1",
"강원특별자치도","15세미만","2019 년","171615","88287","83328","106","171104","88034","83070","106",
"강원특별자치도","15세미만","2020 년","168414","86491","81923","105.6","167952","86267","81685","105.6",
"강원특별자치도","15세미만","2021 년","164532","84493","80039","105.6","164036","84236","79800","105.6",
"강원특별자치도","15세미만","2022 년","159135","81697","77438","105.5","158554","81391","77163","105.5",
"강원특별자치도","15세미만","2023 년","152473","78253","74220","105.4","151949","77984","73965","105.4",
"강원특별자치도","15~64세","2015 년","1069468","561935","507533","110.7","1052334","552869","499465","110.7",
"강원특별자치도","15~64세","2016 년","1075770","564968","510802","110.6","1057577","555189","502388","110.5",
"강원특별자치도","15~64세","2017 년","1068237","561225","507012","110.7","1048262","550420","497842","110.6",
"강원특별자치도","15~64세","2018 년","1064037","559278","504759","110.8","1040984","546711","494273","110.6",
"강원특별자치도","15~64세","2019 년","1056039","554316","501723","110.5","1030416","540357","490059","110.3",
"강원특별자치도","15~64세","2020 년","1044372","547722","496650","110.3","1021025","535480","485545","110.3",
"강원특별자치도","15~64세","2021 년","1033229","541296","491933","110","1010068","529225","480843","110.1",
"강원특별자치도","15~64세","2022 년","1027860","538646","489214","110.1","1001896","524649","477247","109.9",
"강원특별자치도","15~64세","2023 년","1017617","533754","483863","110.3","986270","516362","469908","109.9",
"강원특별자치도","65세이상","2015 년","254803","106088","148715","71.3","254088","105744","148344","71.3",
"강원특별자치도","65세이상","2016 년","258392","107810","150582","71.6","257668","107478","150190","71.6",
"강원특별자치도","65세이상","2017 년","271493","114175","157318","72.6","270748","113834","156914","72.5",
"강원특별자치도","65세이상","2018 년","280036","118561","161475","73.4","279292","118222","161070","73.4",
"강원특별자치도","65세이상","2019 년","292473","125114","167359","74.8","291599","124707","166892","74.7",
"강원특별자치도","65세이상","2020 년","308977","133461","175516","76","308132","133084","175048","76",
"강원특별자치도","65세이상","2021 년","324129","141278","182851","77.3","323204","140893","182311","77.3",
"강원특별자치도","65세이상","2022 년","341042","150175","190867","78.7","339954","149712","190242","78.7",
"강원특별자치도","65세이상","2023 년","357924","158817","199107","79.8","356655","158290","198365","79.8",
"강원특별자치도","85세이상","2015 년","23053","6004","17049","35.2","23015","5989","17026","35.2",
"강원특별자치도","85세이상","2016 년","24332","6299","18033","34.9","24297","6287","18010","34.9",
"강원특별자치도","85세이상","2017 년","26015","6707","19308","34.7","25988","6700","19288","34.7",
"강원특별자치도","85세이상","2018 년","27701","7206","20495","35.2","27668","7196","20472","35.2",
"강원특별자치도","85세이상","2019 년","29941","7785","22156","35.1","29889","7763","22126","35.1",
"강원특별자치도","85세이상","2020 년","32690","8679","24011","36.1","32653","8670","23983","36.2",
"강원특별자치도","85세이상","2021 년","35894","9892","26002","38","35857","9885","25972","38.1",
"강원특별자치도","85세이상","2022 년","38127","10777","27350","39.4","38081","10767","27314","39.4",
"강원특별자치도","85세이상","2023 년","41165","11901","29264","40.7","41104","11882","29222","40.7",
"강원특별자치도","평균연령","2015 년","42.6","41","44.3","","42.7","41","44.4","",
"강원특별자치도","평균연령","2016 년","43.1","41.5","44.8","","43.2","41.6","44.8","",
"강원특별자치도","평균연령","2017 년","43.7","42.1","45.4","","43.8","42.2","45.5","",
"강원특별자치도","평균연령","2018 년","44.3","42.6","45.9","","44.4","42.8","46.1","",
"강원특별자치도","평균연령","2019 년","44.9","43.3","46.5","","45","43.4","46.6","",
"강원특별자치도","평균연령","2020 년","45.5","43.9","47.1","","45.6","44.1","47.3","",
"강원특별자치도","평균연령","2021 년","46.1","44.5","47.7","","46.3","44.7","47.8","",
"강원특별자치도","평균연령","2022 년","46.6","45","48.2","","46.8","45.2","48.3","",
"강원특별자치도","평균연령","2023 년","47.1","45.6","48.7","","47.4","45.8","48.9","",
"강원특별자치도","중위연령","2015 년","44","42.3","45.8","","44.2","42.5","46","",
"강원특별자치도","중위연령","2016 년","44.7","43","46.5","","44.9","43.2","46.6","",
"강원특별자치도","중위연령","2017 년","45.5","43.7","47.2","","45.7","44","47.4","",
"강원특별자치도","중위연령","2018 년","46.2","44.5","48","","46.5","44.8","48.2","",
"강원특별자치도","중위연령","2019 년","46.9","45.3","48.7","","47.3","45.6","49","",
"강원특별자치도","중위연령","2020 년","47.8","46.1","49.5","","48.1","46.5","49.8","",
"강원특별자치도","중위연령","2021 년","48.6","46.9","50.3","","48.9","47.2","50.6","",
"강원특별자치도","중위연령","2022 년","49.2","47.4","50.9","","49.5","47.9","51.2","",
"강원특별자치도","중위연령","2023 년","49.8","48.1","51.6","","50.3","48.7","52","",
"충청북도","합계","2015 년","1589347","805377","783970","102.7","1548589","779961","768628","101.5",
"충청북도","합계","2016 년","1603404","814049","789355","103.1","1558503","785824","772679","101.7",
"충청북도","합계","2017 년","1611009","818500","792509","103.3","1562772","788322","774450","101.8",
"충청북도","합계","2018 년","1620935","826183","794752","104","1566100","791904","774196","102.3",
"충청북도","합계","2019 년","1629343","832543","796800","104.5","1569560","795522","774038","102.8",
"충청북도","합계","2020 년","1632088","833819","798269","104.5","1574994","799168","775826","103",
"충청북도","합계","2021 년","1624764","828073","796691","103.9","1568133","794362","773771","102.7",
"충청북도","합계","2022 년","1624993","830923","794070","104.6","1563376","793399","769977","103",
"충청북도","합계","2023 년","1641481","842776","798705","105.5","1570170","798432","771738","103.5",
"충청북도","0~4세","2015 년","69659","35481","34178","103.8","69298","35296","34002","103.8",
"충청북도","0~4세","2016 년","68300","34795","33505","103.9","67807","34541","33266","103.8",
"충청북도","0~4세","2017 년","64931","33083","31848","103.9","64328","32785","31543","103.9",
"충청북도","0~4세","2018 년","62106","31660","30446","104","61354","31261","30093","103.9",
"충청북도","0~4세","2019 년","58676","30021","28655","104.8","57751","29552","28199","104.8",
"충청북도","0~4세","2020 년","54135","27894","26241","106.3","53233","27410","25823","106.1",
"충청북도","0~4세","2021 년","49661","25522","24139","105.7","48618","24977","23641","105.7",
"충청북도","0~4세","2022 년","45657","23437","22220","105.5","44631","22922","21709","105.6",
"충청북도","0~4세","2023 년","42688","21947","20741","105.8","41672","21442","20230","106",
"충청북도","5~9세","2015 년","70899","36685","34214","107.2","70612","36539","34073","107.2",
"충청북도","5~9세","2016 년","72243","37336","34907","107","71868","37142","34726","107",
"충청북도","5~9세","2017 년","72095","37142","34953","106.3","71716","36962","34754","106.4",
"충청북도","5~9세","2018 년","71283","36546","34737","105.2","70796","36313","34483","105.3",
"충청북도","5~9세","2019 년","71263","36251","35012","103.5","70566","35915","34651","103.6",
"충청북도","5~9세","2020 년","70381","35778","34603","103.4","69708","35453","34255","103.5",
"충청북도","5~9세","2021 년","68719","34959","33760","103.6","67749","34479","33270","103.6",
"충청북도","5~9세","2022 년","65144","33197","31947","103.9","64127","32679","31448","103.9",
"충청북도","5~9세","2023 년","61903","31580","30323","104.1","60886","31064","29822","104.2",
"충청북도","10~14세","2015 년","76851","40144","36707","109.4","76637","40037","36600","109.4",
"충청북도","10~14세","2016 년","72190","37639","34551","108.9","71958","37525","34433","109",
"충청북도","10~14세","2017 년","71447","37130","34317","108.2","71209","37003","34206","108.2",
"충청북도","10~14세","2018 년","71002","36866","34136","108","70678","36694","33984","108",
"충청북도","10~14세","2019 년","70241","36486","33755","108.1","69786","36247","33539","108.1",
"충청북도","10~14세","2020 년","71406","36949","34457","107.2","70968","36712","34256","107.2",
"충청북도","10~14세","2021 년","72793","37578","35215","106.7","72159","37265","34894","106.8",
"충청북도","10~14세","2022 년","72644","37469","35175","106.5","71901","37096","34805","106.6",
"충청북도","10~14세","2023 년","71805","36897","34908","105.7","70972","36479","34493","105.8",
"충청북도","15~19세","2015 년","106539","55891","50648","110.4","105894","55577","50317","110.5",
"충청북도","15~19세","2016 년","103069","54018","49051","110.1","102312","53649","48663","110.2",
"충청북도","15~19세","2017 년","96815","50954","45861","111.1","95873","50435","45438","111",
"충청북도","15~19세","2018 년","91800","48510","43290","112.1","90662","47905","42757","112",
"충청북도","15~19세","2019 년","87200","46116","41084","112.2","85988","45453","40535","112.1",
"충청북도","15~19세","2020 년","80349","42301","38048","111.2","79576","41872","37704","111.1",
"충청북도","15~19세","2021 년","74333","38856","35477","109.5","73621","38478","35143","109.5",
"충청북도","15~19세","2022 년","73194","38189","35005","109.1","72068","37579","34489","109",
"충청북도","15~19세","2023 년","74640","39046","35594","109.7","72988","38073","34915","109",
"충청북도","20~24세","2015 년","113414","62172","51242","121.3","108456","59331","49125","120.8",
"충청북도","20~24세","2016 년","119018","65689","53329","123.2","113189","62101","51088","121.6",
"충청북도","20~24세","2017 년","118717","65217","53500","121.9","112596","61397","51199","119.9",
"충청북도","20~24세","2018 년","117659","65165","52494","124.1","110420","60500","49920","121.2",
"충청북도","20~24세","2019 년","115325","64204","51121","125.6","107757","59346","48411","122.6",
"충청북도","20~24세","2020 년","112671","62251","50420","123.5","106223","58181","48042","121.1",
"충청북도","20~24세","2021 년","104543","57048","47495","120.1","99144","53843","45301","118.9",
"충청북도","20~24세","2022 년","97068","53724","43344","123.9","91288","50048","41240","121.4",
"충청북도","20~24세","2023 년","98679","55314","43365","127.6","91106","50362","40744","123.6",
"충청북도","25~29세","2015 년","94540","52293","42247","123.8","86747","47206","39541","119.4",
"충청북도","25~29세","2016 년","96743","54042","42701","126.6","88270","48432","39838","121.6",
"충청북도","25~29세","2017 년","99523","56215","43308","129.8","90676","50340","40336","124.8",
"충청북도","25~29세","2018 년","103505","59358","44147","134.5","93665","52809","40856","129.3",
"충청북도","25~29세","2019 년","107289","62250","45039","138.2","96911","55389","41522","133.4",
"충청북도","25~29세","2020 년","110612","64492","46120","139.8","101030","58224","42806","136",
"충청북도","25~29세","2021 년","109466","63488","45978","138.1","100476","57629","42847","134.5",
"충청북도","25~29세","2022 년","109537","63281","46256","136.8","99612","56597","43015","131.6",
"충청북도","25~29세","2023 년","110177","63804","46373","137.6","98351","55531","42820","129.7",
"충청북도","30~34세","2015 년","108441","57870","50571","114.4","101981","53412","48569","110",
"충청북도","30~34세","2016 년","105171","56451","48720","115.9","98108","51638","46470","111.1",
"충청북도","30~34세","2017 년","100098","54074","46024","117.5","92156","48691","43465","112",
"충청북도","30~34세","2018 년","97768","53421","44347","120.5","88653","47305","41348","114.4",
"충청북도","30~34세","2019 년","96888","53193","43695","121.7","86830","46564","40266","115.6",
"충청북도","30~34세","2020 년","96749","53535","43214","123.9","86765","47102","39663","118.8",
"충청북도","30~34세","2021 년","96856","53699","43157","124.4","87190","47521","39669","119.8",
"충청북도","30~34세","2022 년","100144","56755","43389","130.8","89919","50033","39886","125.4",
"충청북도","30~34세","2023 년","105710","60880","44830","135.8","93858","52832","41026","128.8",
"충청북도","35~39세","2015 년","112462","59055","53407","110.6","107780","55747","52033","107.1",
"충청북도","35~39세","2016 년","113582","59855","53727","111.4","108415","56198","52217","107.6",
"충청북도","35~39세","2017 년","116122","61092","55030","111","110424","57179","53245","107.4",
"충청북도","35~39세","2018 년","117850","62202","55648","111.8","110983","57554","53429","107.7",
"충청북도","35~39세","2019 년","115928","61457","54471","112.8","108382","56463","51919","108.8",
"충청북도","35~39세","2020 년","111096","58944","52152","113","103470","54014","49456","109.2",
"충청북도","35~39세","2021 년","106838","56792","50046","113.5","99118","51924","47194","110",
"충청북도","35~39세","2022 년","101738","54715","47023","116.4","93175","49185","43990","111.8",
"충청북도","35~39세","2023 년","99576","54092","45484","118.9","89684","47681","42003","113.5",
"충청북도","40~44세","2015 년","125782","65379","60403","108.2","122035","62957","59078","106.6",
"충청북도","40~44세","2016 년","121128","62923","58205","108.1","117220","60433","56787","106.4",
"충청북도","40~44세","2017 년","119249","61810","57439","107.6","115204","59261","55943","105.9",
"충청북도","40~44세","2018 년","115493","60046","55447","108.3","110859","57150","53709","106.4",
"충청북도","40~44세","2019 년","113640","59283","54357","109.1","108378","55963","52415","106.8",
"충청북도","40~44세","2020 년","114380","59730","54650","109.3","109162","56480","52682","107.2",
"충청북도","40~44세","2021 년","115376","60308","55068","109.5","109926","56910","53016","107.3",
"충청북도","40~44세","2022 년","117988","61825","56163","110.1","111953","58039","53914","107.7",
"충청북도","40~44세","2023 년","119451","62816","56635","110.9","112511","58394","54117","107.9",
"충청북도","45~49세","2015 년","134300","69105","65195","106","130694","67010","63684","105.2",
"충청북도","45~49세","2016 년","135838","69737","66101","105.5","132036","67495","64541","104.6",
"충청북도","45~49세","2017 년","135000","69526","65474","106.2","130882","67102","63780","105.2",
"충청북도","45~49세","2018 년","133310","68972","64338","107.2","128909","66392","62517","106.2",
"충청북도","45~49세","2019 년","130855","67998","62857","108.2","126317","65375","60942","107.3",
"충청북도","45~49세","2020 년","128136","66220","61916","107","123911","63845","60066","106.3",
"충청북도","45~49세","2021 년","123134","63538","59596","106.6","118973","61218","57755","106",
"충청북도","45~49세","2022 년","121191","62471","58720","106.4","116852","60017","56835","105.6",
"충청북도","45~49세","2023 년","117136","60537","56599","107","112401","57879","54522","106.2",
"충청북도","50~54세","2015 년","131746","68133","63613","107.1","128516","66329","62187","106.7",
"충청북도","50~54세","2016 년","127449","66108","61341","107.8","123802","64035","59767","107.1",
"충청북도","50~54세","2017 년","126496","65359","61137","106.9","122843","63303","59540","106.3",
"충청북도","50~54세","2018 년","130773","67034","63739","105.2","127005","64933","62072","104.6",
"충청북도","50~54세","2019 년","137475","70336","67139","104.8","133346","67999","65347","104.1",
"충청북도","50~54세","2020 년","137809","70557","67252","104.9","133879","68416","65463","104.5",
"충청북도","50~54세","2021 년","139405","71068","68337","104","135348","68849","66499","103.5",
"충청북도","50~54세","2022 년","138406","70932","67474","105.1","134073","68542","65531","104.6",
"충청북도","50~54세","2023 년","136563","70308","66255","106.1","131993","67798","64195","105.6",
"충청북도","55~59세","2015 년","124779","63493","61286","103.6","122406","62109","60297","103",
"충청북도","55~59세","2016 년","133712","67906","65806","103.2","131247","66532","64715","102.8",
"충청북도","55~59세","2017 년","137450","70034","67416","103.9","134865","68632","66233","103.6",
"충청북도","55~59세","2018 년","137525","70114","67411","104","134566","68541","66025","103.8",
"충청북도","55~59세","2019 년","135596","69416","66180","104.9","132320","67651","64669","104.6",
"충청북도","55~59세","2020 년","135185","69535","65650","105.9","131928","67795","64133","105.7",
"충청북도","55~59세","2021 년","130685","67367","63318","106.4","127130","65483","61647","106.2",
"충청북도","55~59세","2022 년","130260","66920","63340","105.7","126624","64981","61643","105.4",
"충청북도","55~59세","2023 년","134773","68591","66182","103.6","130993","66600","64393","103.4",
"충청북도","60~64세","2015 년","89402","44393","45009","98.6","88088","43643","44445","98.2",
"충청북도","60~64세","2016 년","99665","49872","49793","100.2","98139","48973","49166","99.6",
"충청북도","60~64세","2017 년","106038","53233","52805","100.8","104240","52178","52062","100.2",
"충청북도","60~64세","2018 년","115153","58123","57030","101.9","113209","56990","56219","101.4",
"충청북도","60~64세","2019 년","121813","61505","60308","102","119685","60335","59350","101.7",
"충청북도","60~64세","2020 년","128155","64654","63501","101.8","125940","63502","62438","101.7",
"충청북도","60~64세","2021 년","137471","69364","68107","101.8","135216","68236","66980","101.9",
"충청북도","60~64세","2022 년","140699","71233","69466","102.5","138283","70021","68262","102.6",
"충청북도","60~64세","2023 년","141408","71772","69636","103.1","138631","70387","68244","103.1",
"충청북도","65~69세","2015 년","64722","31531","33191","95","64105","31211","32894","94.9",
"충청북도","65~69세","2016 년","66606","32400","34206","94.7","65921","32045","33876","94.6",
"충청북도","65~69세","2017 년","72124","35321","36803","96","71375","34940","36435","95.9",
"충청북도","65~69세","2018 년","75066","36807","38259","96.2","74232","36381","37851","96.1",
"충청북도","65~69세","2019 년","80612","39510","41102","96.1","79658","39007","40651","96",
"충청북도","65~69세","2020 년","89589","44008","45581","96.5","88503","43449","45054","96.4",
"충청북도","65~69세","2021 년","99920","49420","50500","97.9","98726","48795","49931","97.7",
"충청북도","65~69세","2022 년","106332","52836","53496","98.8","104859","52074","52785","98.7",
"충청북도","65~69세","2023 년","114947","57419","57528","99.8","113320","56615","56705","99.8",
"충청북도","70~74세","2015 년","61742","27180","34562","78.6","61537","27088","34449","78.6",
"충청북도","70~74세","2016 년","59285","26414","32871","80.4","59066","26318","32748","80.4",
"충청북도","70~74세","2017 년","57665","26132","31533","82.9","57403","26012","31391","82.9",
"충청북도","70~74세","2018 년","58786","27195","31591","86.1","58495","27079","31416","86.2",
"충청북도","70~74세","2019 년","60669","28779","31890","90.2","60286","28608","31678","90.3",
"충청북도","70~74세","2020 년","62384","29703","32681","90.9","61963","29525","32438","91",
"충청북도","70~74세","2021 년","64180","30567","33613","90.9","63705","30357","33348","91",
"충청북도","70~74세","2022 년","69762","33514","36248","92.5","69201","33284","35917","92.7",
"충청북도","70~74세","2023 년","72738","35022","37716","92.9","72052","34717","37335","93",
"충청북도","75~79세","2015 년","51910","20832","31078","67","51766","20773","30993","67",
"충청북도","75~79세","2016 년","53112","21566","31546","68.4","52971","21515","31456","68.4",
"충청북도","75~79세","2017 년","56653","23258","33395","69.6","56519","23221","33298","69.7",
"충청북도","75~79세","2018 년","57258","23693","33565","70.6","57127","23651","33476","70.7",
"충청북도","75~79세","2019 년","56436","23339","33097","70.5","56303","23295","33008","70.6",
"충청북도","75~79세","2020 년","56045","23513","32532","72.3","55887","23465","32422","72.4",
"충청북도","75~79세","2021 년","54105","23060","31045","74.3","53927","22993","30934","74.3",
"충청북도","75~79세","2022 년","52693","22903","29790","76.9","52464","22818","29646","77",
"충청북도","75~79세","2023 년","53841","24025","29816","80.6","53530","23910","29620","80.7",
"충청북도","80~84세","2015 년","32121","10650","21471","49.6","32049","10621","21428","49.6",
"충청북도","80~84세","2016 년","35197","11992","23205","51.7","35130","11962","23168","51.6",
"충청북도","80~84세","2017 년","37632","13093","24539","53.4","37549","13066","24483","53.4",
"충청북도","80~84세","2018 년","39429","14008","25421","55.1","39353","13991","25362","55.2",
"충청북도","80~84세","2019 년","41700","15117","26583","56.9","41611","15094","26517","56.9",
"충청북도","80~84세","2020 년","42272","15521","26751","58","42162","15501","26661","58.1",
"충청북도","80~84세","2021 년","43666","16238","27428","59.2","43554","16216","27338","59.3",
"충청북도","80~84세","2022 년","46757","17606","29151","60.4","46631","17582","29049","60.5",
"충청북도","80~84세","2023 년","47323","17973","29350","61.2","47189","17935","29254","61.3",
"충청북도","85~89세","2015 년","14212","3800","10412","36.5","14181","3790","10391","36.5",
"충청북도","85~89세","2016 년","15024","3962","11062","35.8","14993","3952","11041","35.8",
"충청북도","85~89세","2017 년","16273","4327","11946","36.2","16242","4318","11924","36.2",
"충청북도","85~89세","2018 년","17889","4859","13030","37.3","17861","4853","13008","37.3",
"충청북도","85~89세","2019 년","19575","5483","14092","38.9","19540","5470","14070","38.9",
"충청북도","85~89세","2020 년","21740","6288","15452","40.7","21702","6277","15425","40.7",
"충청북도","85~89세","2021 년","24160","7162","16998","42.1","24108","7152","16956","42.2",
"충청북도","85~89세","2022 년","25708","7737","17971","43.1","25654","7725","17929","43.1",
"충청북도","85~89세","2023 년","27132","8403","18729","44.9","27057","8387","18670","44.9",
"충청북도","90~94세","2015 년","4835","1144","3691","31","4822","1141","3681","31",
"충청북도","90~94세","2016 년","4894","1160","3734","31.1","4876","1155","3721","31",
"충청북도","90~94세","2017 년","5306","1240","4066","30.5","5298","1237","4061","30.5",
"충청북도","90~94세","2018 년","5759","1321","4438","29.8","5753","1320","4433","29.8",
"충청북도","90~94세","2019 년","6560","1493","5067","29.5","6549","1491","5058","29.5",
"충청북도","90~94세","2020 년","7230","1601","5629","28.4","7222","1601","5621","28.5",
"충청북도","90~94세","2021 년","7648","1706","5942","28.7","7642","1705","5937","28.7",
"충청북도","90~94세","2022 년","8166","1819","6347","28.7","8158","1818","6340","28.7",
"충청북도","90~94세","2023 년","8966","1978","6988","28.3","8953","1975","6978","28.3",
"충청북도","95~99세","2015 년","850","130","720","18.1","845","128","717","17.9",
"충청북도","95~99세","2016 년","1042","169","873","19.4","1040","168","872","19.3",
"충청북도","95~99세","2017 년","1241","242","999","24.2","1240","242","998","24.2",
"충청북도","95~99세","2018 년","1361","267","1094","24.4","1360","266","1094","24.3",
"충청북도","95~99세","2019 년","1427","282","1145","24.6","1421","281","1140","24.6",
"충청북도","95~99세","2020 년","1556","315","1241","25.4","1554","314","1240","25.3",
"충청북도","95~99세","2021 년","1573","301","1272","23.7","1571","300","1271","23.6",
"충청북도","95~99세","2022 년","1641","310","1331","23.3","1639","309","1330","23.2",
"충청북도","95~99세","2023 년","1784","337","1447","23.3","1782","336","1446","23.2",
"충청북도","100세이상","2015 년","141","16","125","12.8","140","16","124","12.9",
"충청북도","100세이상","2016 년","136","15","121","12.4","135","15","120","12.5",
"충청북도","100세이상","2017 년","134","18","116","15.5","134","18","116","15.5",
"충청북도","100세이상","2018 년","160","16","144","11.1","160","16","144","11.1",
"충청북도","100세이상","2019 년","175","24","151","15.9","175","24","151","15.9",
"충청북도","100세이상","2020 년","208","30","178","16.9","208","30","178","16.9",
"충청북도","100세이상","2021 년","232","32","200","16","232","32","200","16",
"충청북도","100세이상","2022 년","264","50","214","23.4","264","50","214","23.4",
"충청북도","100세이상","2023 년","241","35","206","17","241","35","206","17",
"충청북도","15세미만","2015 년","217409","112310","105099","106.9","216547","111872","104675","106.9",
"충청북도","15세미만","2016 년","212733","109770","102963","106.6","211633","109208","102425","106.6",
"충청북도","15세미만","2017 년","208473","107355","101118","106.2","207253","106750","100503","106.2",
"충청북도","15세미만","2018 년","204391","105072","99319","105.8","202828","104268","98560","105.8",
"충청북도","15세미만","2019 년","200180","102758","97422","105.5","198103","101714","96389","105.5",
"충청북도","15세미만","2020 년","195922","100621","95301","105.6","193909","99575","94334","105.6",
"충청북도","15세미만","2021 년","191173","98059","93114","105.3","188526","96721","91805","105.4",
"충청북도","15세미만","2022 년","183445","94103","89342","105.3","180659","92697","87962","105.4",
"충청북도","15세미만","2023 년","176396","90424","85972","105.2","173530","88985","84545","105.3",
"충청북도","15~64세","2015 년","1141405","597784","543621","110","1102597","573321","529276","108.3",
"충청북도","15~64세","2016 년","1155375","606601","548774","110.5","1112738","579486","533252","108.7",
"충청북도","15~64세","2017 년","1155508","607514","547994","110.9","1109759","578518","531241","108.9",
"충청북도","15~64세","2018 년","1160836","612945","547891","111.9","1108931","580079","528852","109.7",
"충청북도","15~64세","2019 년","1162009","615758","546251","112.7","1105914","580538","525376","110.5",
"충청북도","15~64세","2020 년","1155142","612219","542923","112.8","1101884","579431","522453","110.9",
"충청북도","15~64세","2021 년","1138107","601528","536579","112.1","1086142","570091","516051","110.5",
"충청북도","15~64세","2022 년","1130225","600045","530180","113.2","1073847","565042","508805","111.1",
"충청북도","15~64세","2023 년","1138113","607160","530953","114.4","1072516","565537","506979","111.6",
"충청북도","65세이상","2015 년","230533","95283","135250","70.4","229445","94768","134677","70.4",
"충청북도","65세이상","2016 년","235296","97678","137618","71","234132","97130","137002","70.9",
"충청북도","65세이상","2017 년","247028","103631","143397","72.3","245760","103054","142706","72.2",
"충청북도","65세이상","2018 년","255708","108166","147542","73.3","254341","107557","146784","73.3",
"충청북도","65세이상","2019 년","267154","114027","153127","74.5","265543","113270","152273","74.4",
"충청북도","65세이상","2020 년","281024","120979","160045","75.6","279201","120162","159039","75.6",
"충청북도","65세이상","2021 년","295484","128486","166998","76.9","293465","127550","165915","76.9",
"충청북도","65세이상","2022 년","311323","136775","174548","78.4","308870","135660","173210","78.3",
"충청북도","65세이상","2023 년","326972","145192","181780","79.9","324124","143910","180214","79.9",
"충청북도","85세이상","2015 년","20038","5090","14948","34.1","19988","5075","14913","34",
"충청북도","85세이상","2016 년","21096","5306","15790","33.6","21044","5290","15754","33.6",
"충청북도","85세이상","2017 년","22954","5827","17127","34","22914","5815","17099","34",
"충청북도","85세이상","2018 년","25169","6463","18706","34.6","25134","6455","18679","34.6",
"충청북도","85세이상","2019 년","27737","7282","20455","35.6","27685","7266","20419","35.6",
"충청북도","85세이상","2020 년","30734","8234","22500","36.6","30686","8222","22464","36.6",
"충청북도","85세이상","2021 년","33613","9201","24412","37.7","33553","9189","24364","37.7",
"충청북도","85세이상","2022 년","35779","9916","25863","38.3","35715","9902","25813","38.4",
"충청북도","85세이상","2023 년","38123","10753","27370","39.3","38033","10733","27300","39.3",
"충청북도","평균연령","2015 년","41","39.6","42.4","","41.1","39.7","42.5","",
"충청북도","평균연령","2016 년","41.4","40","42.8","","41.5","40.1","42.9","",
"충청북도","평균연령","2017 년","41.9","40.5","43.4","","42.1","40.7","43.5","",
"충청북도","평균연령","2018 년","42.4","41","43.9","","42.6","41.2","44","",
"충청북도","평균연령","2019 년","42.9","41.5","44.4","","43.2","41.7","44.6","",
"충청북도","평균연령","2020 년","43.5","42","45","","43.7","42.3","45.2","",
"충청북도","평균연령","2021 년","44.2","42.7","45.6","","44.4","43","45.8","",
"충청북도","평균연령","2022 년","44.7","43.3","46.2","","45","43.6","46.5","",
"충청북도","평균연령","2023 년","45.1","43.7","46.7","","45.5","44.1","46.9","",
"충청북도","중위연령","2015 년","41.7","40.3","43.2","","42","40.6","43.4","",
"충청북도","중위연령","2016 년","42.2","40.6","43.8","","42.5","41.1","44","",
"충청북도","중위연령","2017 년","42.9","41.2","44.5","","43.3","41.8","44.8","",
"충청북도","중위연령","2018 년","43.5","41.7","45.2","","44","42.4","45.5","",
"충청북도","중위연령","2019 년","44.1","42.2","45.9","","44.7","43","46.3","",
"충청북도","중위연령","2020 년","44.7","42.9","46.6","","45.3","43.6","47","",
"충청북도","중위연령","2021 년","45.6","43.8","47.5","","46.2","44.5","47.8","",
"충청북도","중위연령","2022 년","46.3","44.4","48.3","","47","45.2","48.7","",
"충청북도","중위연령","2023 년","46.6","44.6","48.8","","47.5","45.7","49.3","",
"충청남도","합계","2015 년","2107802","1078310","1029492","104.7","2036720","1034139","1002581","103.1",
"충청남도","합계","2016 년","2132566","1091091","1041475","104.8","2055033","1043049","1011984","103.1",
"충청남도","합계","2017 년","2162426","1108610","1053816","105.2","2077674","1056508","1021166","103.5",
"충청남도","합계","2018 년","2181416","1119996","1061420","105.5","2085578","1061485","1024093","103.7",
"충청남도","합계","2019 년","2188649","1124678","1063971","105.7","2084631","1061585","1023046","103.8",
"충청남도","합계","2020 년","2176636","1117575","1059061","105.5","2077470","1058869","1018601","104",
"충청남도","합계","2021 년","2175960","1116818","1059142","105.4","2077348","1059208","1018140","104",
"충청남도","합계","2022 년","2193214","1128115","1065099","105.9","2084595","1064010","1020585","104.3",
"충청남도","합계","2023 년","2216332","1144200","1072132","106.7","2089495","1068033","1021462","104.6",
"충청남도","0~4세","2015 년","97138","49993","47145","106","96344","49558","46786","105.9",
"충청남도","0~4세","2016 년","95828","48964","46864","104.5","94805","48428","46377","104.4",
"충청남도","0~4세","2017 년","92367","47150","45217","104.3","91126","46524","44602","104.3",
"충청남도","0~4세","2018 년","88159","44922","43237","103.9","86621","44147","42474","103.9",
"충청남도","0~4세","2019 년","82712","42212","40500","104.2","80868","41295","39573","104.4",
"충청남도","0~4세","2020 년","75539","38624","36915","104.6","73751","37726","36025","104.7",
"충청남도","0~4세","2021 년","68991","35349","33642","105.1","67041","34393","32648","105.3",
"충청남도","0~4세","2022 년","63582","32493","31089","104.5","61546","31499","30047","104.8",
"충청남도","0~4세","2023 년","59227","30364","28863","105.2","57137","29304","27833","105.3",
"충청남도","5~9세","2015 년","98242","50893","47349","107.5","97816","50670","47146","107.5",
"충청남도","5~9세","2016 년","100534","52093","48441","107.5","99909","51766","48143","107.5",
"충청남도","5~9세","2017 년","101812","52615","49197","106.9","101160","52257","48903","106.9",
"충청남도","5~9세","2018 년","101586","52389","49197","106.5","100687","51918","48769","106.5",
"충청남도","5~9세","2019 년","100919","51978","48941","106.2","99683","51323","48360","106.1",
"충청남도","5~9세","2020 년","99473","51033","48440","105.4","98233","50398","47835","105.4",
"충청남도","5~9세","2021 년","96901","49566","47335","104.7","95193","48687","46506","104.7",
"충청남도","5~9세","2022 년","92146","47163","44983","104.8","90079","46116","43963","104.9",
"충청남도","5~9세","2023 년","87572","44871","42701","105.1","85427","43795","41632","105.2",
"충청남도","10~14세","2015 년","100657","52223","48434","107.8","100402","52094","48308","107.8",
"충청남도","10~14세","2016 년","96299","49907","46392","107.6","95974","49750","46224","107.6",
"충청남도","10~14세","2017 년","97084","50269","46815","107.4","96711","50064","46647","107.3",
"충청남도","10~14세","2018 년","97915","50647","47268","107.1","97353","50353","47000","107.1",
"충청남도","10~14세","2019 년","97767","50526","47241","107","97011","50113","46898","106.9",
"충청남도","10~14세","2020 년","99816","51744","48072","107.6","98989","51289","47700","107.5",
"충청남도","10~14세","2021 년","101779","52812","48967","107.9","100703","52247","48456","107.8",
"충청남도","10~14세","2022 년","102492","52999","49493","107.1","101049","52261","48788","107.1",
"충청남도","10~14세","2023 년","101795","52638","49157","107.1","100097","51751","48346","107",
"충청남도","15~19세","2015 년","135925","71225","64700","110.1","134778","70712","64066","110.4",
"충청남도","15~19세","2016 년","133487","69607","63880","109","132137","69012","63125","109.3",
"충청남도","15~19세","2017 년","128419","67255","61164","110","126640","66462","60178","110.4",
"충청남도","15~19세","2018 년","123026","64278","58748","109.4","120816","63241","57575","109.8",
"충청남도","15~19세","2019 년","118253","61663","56590","109","115881","60573","55308","109.5",
"충청남도","15~19세","2020 년","107031","55685","51346","108.5","105327","54907","50420","108.9",
"충청남도","15~19세","2021 년","102279","53049","49230","107.8","100723","52286","48437","107.9",
"충청남도","15~19세","2022 년","105486","54917","50569","108.6","103236","53730","49506","108.5",
"충청남도","15~19세","2023 년","106679","55438","51241","108.2","103648","53767","49881","107.8",
"충청남도","20~24세","2015 년","144660","77338","67322","114.9","135706","72342","63364","114.2",
"충청남도","20~24세","2016 년","149280","79892","69388","115.1","139392","74262","65130","114",
"충청남도","20~24세","2017 년","148933","79921","69012","115.8","138349","73928","64421","114.8",
"충청남도","20~24세","2018 년","148850","80883","67967","119","136454","73689","62765","117.4",
"충청남도","20~24세","2019 년","146308","79091","67217","117.7","133469","71675","61794","116",
"충청남도","20~24세","2020 년","138808","74858","63950","117.1","127916","68805","59111","116.4",
"충청남도","20~24세","2021 년","133478","71315","62163","114.7","123739","66129","57610","114.8",
"충청남도","20~24세","2022 년","132325","70998","61327","115.8","121223","64914","56309","115.3",
"충청남도","20~24세","2023 년","128133","69258","58875","117.6","114831","61541","53290","115.5",
"충청남도","25~29세","2015 년","127182","71035","56147","126.5","113629","62258","51371","121.2",
"충청남도","25~29세","2016 년","128291","71924","56367","127.6","114044","62541","51503","121.4",
"충청남도","25~29세","2017 년","132844","75318","57526","130.9","117722","65259","52463","124.4",
"충청남도","25~29세","2018 년","135158","76756","58402","131.4","118697","65843","52854","124.6",
"충청남도","25~29세","2019 년","136534","78016","58518","133.3","119097","66494","52603","126.4",
"충청남도","25~29세","2020 년","135452","77631","57821","134.3","119515","67311","52204","128.9",
"충청남도","25~29세","2021 년","134304","77079","57225","134.7","119588","67645","51943","130.2",
"충청남도","25~29세","2022 년","133729","77078","56651","136.1","117652","66602","51050","130.5",
"충청남도","25~29세","2023 년","135427","79040","56387","140.2","116044","66181","49863","132.7",
"충청남도","30~34세","2015 년","152421","84202","68219","123.4","140662","76015","64647","117.6",
"충청남도","30~34세","2016 년","147304","81133","66171","122.6","134323","72301","62022","116.6",
"충청남도","30~34세","2017 년","142897","79028","63869","123.7","128521","69351","59170","117.2",
"충청남도","30~34세","2018 년","139708","77443","62265","124.4","123349","66628","56721","117.5",
"충청남도","30~34세","2019 년","137629","76834","60795","126.4","119934","65204","54730","119.1",
"충청남도","30~34세","2020 년","134317","74888","59429","126","117222","63898","53324","119.8",
"충청남도","30~34세","2021 년","132294","73946","58348","126.7","115955","63548","52407","121.3",
"충청남도","30~34세","2022 년","134873","76109","58764","129.5","117586","64747","52839","122.5",
"충청남도","30~34세","2023 년","140362","80040","60322","132.7","120101","66357","53744","123.5",
"충청남도","35~39세","2015 년","157002","85050","71952","118.2","148381","78909","69472","113.6",
"충청남도","35~39세","2016 년","161684","87950","73734","119.3","152285","81350","70935","114.7",
"충청남도","35~39세","2017 년","167736","91369","76367","119.6","157072","83998","73074","114.9",
"충청남도","35~39세","2018 년","171232","93064","78168","119.1","158758","84729","74029","114.5",
"충청남도","35~39세","2019 년","167421","90855","76566","118.7","153827","82016","71811","114.2",
"충청남도","35~39세","2020 년","158471","86058","72413","118.8","144801","77356","67445","114.7",
"충청남도","35~39세","2021 년","151521","82072","69449","118.2","137511","73270","64241","114.1",
"충청남도","35~39세","2022 년","144867","78879","65988","119.5","129570","69139","60431","114.4",
"충청남도","35~39세","2023 년","142665","78208","64457","121.3","124502","66610","57892","115.1",
"충청남도","40~44세","2015 년","167392","90009","77383","116.3","160404","85296","75108","113.6",
"충청남도","40~44세","2016 년","162513","87050","75463","115.4","155285","82237","73048","112.6",
"충청남도","40~44세","2017 년","162681","86985","75696","114.9","155115","82049","73066","112.3",
"충청남도","40~44세","2018 년","160037","86036","74001","116.3","151487","80492","70995","113.4",
"충청남도","40~44세","2019 년","158686","85226","73460","116","149050","79096","69954","113.1",
"충청남도","40~44세","2020 년","161373","86684","74689","116.1","151756","80666","71090","113.5",
"충청남도","40~44세","2021 년","165136","88911","76225","116.6","155136","82749","72387","114.3",
"충청남도","40~44세","2022 년","169822","91478","78344","116.8","158479","84519","73960","114.3",
"충청남도","40~44세","2023 년","173614","93479","80135","116.7","160318","85347","74971","113.8",
"충청남도","45~49세","2015 년","164903","87551","77352","113.2","158777","83983","74794","112.3",
"충청남도","45~49세","2016 년","172448","91787","80661","113.8","165861","87859","78002","112.6",
"충청남도","45~49세","2017 년","175351","93668","81683","114.7","168014","89319","78695","113.5",
"충청남도","45~49세","2018 년","175970","94315","81655","115.5","167942","89556","78386","114.2",
"충청남도","45~49세","2019 년","175448","94308","81140","116.2","166931","89161","77770","114.6",
"충청남도","45~49세","2020 년","172495","92159","80336","114.7","164549","87466","77083","113.5",
"충청남도","45~49세","2021 년","167069","88887","78182","113.7","159125","84189","74936","112.3",
"충청남도","45~49세","2022 년","165907","88061","77846","113.1","157914","83423","74491","112",
"충청남도","45~49세","2023 년","163642","87267","76375","114.3","154530","81974","72556","113",
"충청남도","50~54세","2015 년","164283","86760","77523","111.9","159194","84033","75161","111.8",
"충청남도","50~54세","2016 년","157710","83553","74157","112.7","151996","80467","71529","112.5",
"충청남도","50~54세","2017 년","158122","83518","74604","111.9","152075","80296","71779","111.9",
"충청남도","50~54세","2018 년","163316","85911","77405","111","157075","82545","74530","110.8",
"충청남도","50~54세","2019 년","169756","89458","80298","111.4","162996","85764","77232","111",
"충청남도","50~54세","2020 년","170448","89941","80507","111.7","163975","86482","77493","111.6",
"충청남도","50~54세","2021 년","178200","94286","83914","112.4","171305","90520","80785","112.1",
"충청남도","50~54세","2022 년","180477","95922","84555","113.4","172812","91689","81123","113",
"충청남도","50~54세","2023 년","181830","96956","84874","114.2","173326","92259","81067","113.8",
"충청남도","55~59세","2015 년","151924","77372","74552","103.8","148410","75506","72904","103.6",
"충청남도","55~59세","2016 년","162864","83190","79674","104.4","159233","81273","77960","104.2",
"충청남도","55~59세","2017 년","169336","86830","82506","105.2","165381","84822","80559","105.3",
"충청남도","55~59세","2018 년","172275","88802","83473","106.4","167709","86476","81233","106.5",
"충청남도","55~59세","2019 년","172052","89402","82650","108.2","166904","86733","80171","108.2",
"충청남도","55~59세","2020 년","170461","89158","81303","109.7","165142","86476","78666","109.9",
"충청남도","55~59세","2021 년","163026","85599","77427","110.6","157321","82751","74570","111",
"충청남도","55~59세","2022 년","163134","85385","77749","109.8","157249","82393","74856","110.1",
"충청남도","55~59세","2023 년","169230","88253","80977","109","163007","85027","77980","109",
"충청남도","60~64세","2015 년","113309","56034","57275","97.8","111107","54880","56227","97.6",
"충청남도","60~64세","2016 년","123639","61406","62233","98.7","121018","60055","60963","98.5",
"충청남도","60~64세","2017 년","130826","65553","65273","100.4","127846","63982","63864","100.2",
"충청남도","60~64세","2018 년","141028","70769","70259","100.7","137876","69130","68746","100.6",
"충청남도","60~64세","2019 년","148630","74683","73947","101","145294","72967","72327","100.9",
"충청남도","60~64세","2020 년","157804","79367","78437","101.2","154302","77662","76640","101.3",
"충청남도","60~64세","2021 년","169640","85800","83840","102.3","166177","84108","82069","102.5",
"충청남도","60~64세","2022 년","175472","89069","86403","103.1","171593","87220","84373","103.4",
"충청남도","60~64세","2023 년","179892","91927","87965","104.5","175292","89717","85575","104.8",
"충청남도","65~69세","2015 년","93066","45464","47602","95.5","92186","45019","47167","95.4",
"충청남도","65~69세","2016 년","97199","47424","49775","95.3","96161","46882","49279","95.1",
"충청남도","65~69세","2017 년","101470","49478","51992","95.2","100306","48874","51432","95",
"충청남도","65~69세","2018 년","102476","50005","52471","95.3","101091","49317","51774","95.3",
"충청남도","65~69세","2019 년","106388","51796","54592","94.9","104782","51007","53775","94.9",
"충청남도","65~69세","2020 년","115488","56440","59048","95.6","113678","55601","58077","95.7",
"충청남도","65~69세","2021 년","125219","61426","63793","96.3","123226","60523","62703","96.5",
"충청남도","65~69세","2022 년","132764","65710","67054","98","130361","64599","65762","98.2",
"충청남도","65~69세","2023 년","143360","71122","72238","98.5","140607","69884","70723","98.8",
"충청남도","70~74세","2015 년","83023","36318","46705","77.8","82682","36170","46512","77.8",
"충청남도","70~74세","2016 년","80326","36022","44304","81.3","79927","35847","44080","81.3",
"충청남도","70~74세","2017 년","78118","35993","42125","85.4","77663","35802","41861","85.5",
"충청남도","70~74세","2018 년","80854","37852","43002","88","80339","37650","42689","88.2",
"충청남도","70~74세","2019 년","85117","40576","44541","91.1","84475","40317","44158","91.3",
"충청남도","70~74세","2020 년","91342","43738","47604","91.9","90622","43452","47170","92.1",
"충청남도","70~74세","2021 년","95159","45517","49642","91.7","94331","45168","49163","91.9",
"충청남도","70~74세","2022 년","99466","47609","51857","91.8","98433","47167","51266","92",
"충청남도","70~74세","2023 년","100615","48167","52448","91.8","99387","47647","51740","92.1",
"충청남도","75~79세","2015 년","75394","30381","45013","67.5","75134","30287","44847","67.5",
"충청남도","75~79세","2016 년","75162","30332","44830","67.7","74883","30228","44655","67.7",
"충청남도","75~79세","2017 년","80124","32499","47625","68.2","79874","32419","47455","68.3",
"충청남도","75~79세","2018 년","79419","32620","46799","69.7","79155","32536","46619","69.8",
"충청남도","75~79세","2019 년","78007","32333","45674","70.8","77697","32218","45479","70.8",
"충청남도","75~79세","2020 년","76790","32212","44578","72.3","76460","32098","44362","72.4",
"충청남도","75~79세","2021 년","74383","32049","42334","75.7","74023","31929","42094","75.9",
"충청남도","75~79세","2022 년","72580","32275","40305","80.1","72105","32128","39977","80.4",
"충청남도","75~79세","2023 년","75415","34136","41279","82.7","74841","33969","40872","83.1",
"충청남도","80~84세","2015 년","50472","18073","32399","55.8","50367","18040","32327","55.8",
"충청남도","80~84세","2016 년","55141","19971","35170","56.8","55021","19930","35091","56.8",
"충청남도","80~84세","2017 년","57553","21011","36542","57.5","57412","20970","36442","57.5",
"충청남도","80~84세","2018 년","60114","22003","38111","57.7","59943","21952","37991","57.8",
"충청남도","80~84세","2019 년","62787","23002","39785","57.8","62605","22954","39651","57.9",
"충청남도","80~84세","2020 년","62494","23171","39323","58.9","62296","23127","39169","59",
"충청남도","80~84세","2021 년","62909","23388","39521","59.2","62680","23331","39349","59.3",
"충청남도","80~84세","2022 년","67237","25200","42037","59.9","66979","25132","41847","60.1",
"충청남도","80~84세","2023 년","66746","25361","41385","61.3","66451","25272","41179","61.4",
"충청남도","85~89세","2015 년","21956","6378","15578","40.9","21915","6365","15550","40.9",
"충청남도","85~89세","2016 년","23443","6763","16680","40.5","23396","6748","16648","40.5",
"충청남도","85~89세","2017 년","26401","7797","18604","41.9","26345","7782","18563","41.9",
"충청남도","85~89세","2018 년","28914","8738","20176","43.3","28860","8723","20137","43.3",
"충청남도","85~89세","2019 년","31609","9854","21755","45.3","31533","9822","21711","45.2",
"충청남도","85~89세","2020 년","35174","10997","24177","45.5","35101","10971","24130","45.5",
"충청남도","85~89세","2021 년","38580","12293","26287","46.8","38506","12269","26237","46.8",
"충청남도","85~89세","2022 년","40063","12814","27249","47","39971","12788","27183","47",
"충청남도","85~89세","2023 년","41823","13351","28472","46.9","41684","13319","28365","47",
"충청남도","90~94세","2015 년","7228","1697","5531","30.7","7208","1693","5515","30.7",
"충청남도","90~94세","2016 년","7588","1785","5803","30.8","7569","1781","5788","30.8",
"충청남도","90~94세","2017 년","8213","1961","6252","31.4","8205","1959","6246","31.4",
"충청남도","90~94세","2018 년","8940","2122","6818","31.1","8929","2119","6810","31.1",
"충청남도","90~94세","2019 년","10102","2396","7706","31.1","10078","2386","7692","31",
"충청남도","90~94세","2020 년","11183","2689","8494","31.7","11161","2682","8479","31.6",
"충청남도","90~94세","2021 년","12176","2933","9243","31.7","12154","2927","9227","31.7",
"충청남도","90~94세","2022 년","13687","3351","10336","32.4","13662","3343","10319","32.4",
"충청남도","90~94세","2023 년","14937","3713","11224","33.1","14908","3704","11204","33.1",
"충청남도","95~99세","2015 년","1442","290","1152","25.2","1437","285","1152","24.7",
"충청남도","95~99세","2016 년","1627","321","1306","24.6","1617","315","1302","24.2",
"충청남도","95~99세","2017 년","1917","366","1551","23.6","1915","365","1550","23.5",
"충청남도","95~99세","2018 년","2198","410","1788","22.9","2196","410","1786","23",
"충청남도","95~99세","2019 년","2229","424","1805","23.5","2221","422","1799","23.5",
"충청남도","95~99세","2020 년","2327","443","1884","23.5","2325","442","1883","23.5",
"충청남도","95~99세","2021 년","2535","482","2053","23.5","2531","481","2050","23.5",
"충청남도","95~99세","2022 년","2690","552","2138","25.8","2682","549","2133","25.7",
"충청남도","95~99세","2023 년","2912","545","2367","23","2903","543","2360","23",
"충청남도","100세이상","2015 년","183","24","159","15.1","181","24","157","15.3",
"충청남도","100세이상","2016 년","199","17","182","9.3","197","17","180","9.4",
"충청남도","100세이상","2017 년","222","26","196","13.3","222","26","196","13.3",
"충청남도","100세이상","2018 년","241","31","210","14.8","241","31","210","14.8",
"충청남도","100세이상","2019 년","295","45","250","18","295","45","250","18",
"충청남도","100세이상","2020 년","350","55","295","18.6","349","54","295","18.3",
"충청남도","100세이상","2021 년","381","59","322","18.3","380","58","322","18",
"충청남도","100세이상","2022 년","415","53","362","14.6","414","52","362","14.4",
"충청남도","100세이상","2023 년","456","66","390","16.9","454","65","389","16.7",
"충청남도","15세미만","2015 년","296037","153109","142928","107.1","294562","152322","142240","107.1",
"충청남도","15세미만","2016 년","292661","150964","141697","106.5","290688","149944","140744","106.5",
"충청남도","15세미만","2017 년","291263","150034","141229","106.2","288997","148845","140152","106.2",
"충청남도","15세미만","2018 년","287660","147958","139702","105.9","284661","146418","138243","105.9",
"충청남도","15세미만","2019 년","281398","144716","136682","105.9","277562","142731","134831","105.9",
"충청남도","15세미만","2020 년","274828","141401","133427","106","270973","139413","131560","106",
"충청남도","15세미만","2021 년","267671","137727","129944","106","262937","135327","127610","106",
"충청남도","15세미만","2022 년","258220","132655","125565","105.6","252674","129876","122798","105.8",
"충청남도","15세미만","2023 년","248594","127873","120721","105.9","242661","124850","117811","106",
"충청남도","15~64세","2015 년","1479001","786576","692425","113.6","1411048","743934","667114","111.5",
"충청남도","15~64세","2016 년","1499220","797492","701728","113.6","1425574","751357","674217","111.4",
"충청남도","15~64세","2017 년","1517145","809445","707700","114.4","1436735","759466","677269","112.1",
"충청남도","15~64세","2018 년","1530600","818257","712343","114.9","1440163","762329","677834","112.5",
"충청남도","15~64세","2019 년","1530717","819536","711181","115.2","1433383","759683","673700","112.8",
"충청남도","15~64세","2020 년","1506660","806429","700231","115.2","1414505","751029","663476","113.2",
"충청남도","15~64세","2021 년","1496947","800944","696003","115.1","1406580","747195","659385","113.3",
"충청남도","15~64세","2022 년","1506092","807896","698196","115.7","1407314","748376","658938","113.6",
"충청남도","15~64세","2023 년","1521474","819866","701608","116.9","1405599","748780","656819","114",
"충청남도","65세이상","2015 년","332764","138625","194139","71.4","331110","137883","193227","71.4",
"충청남도","65세이상","2016 년","340685","142635","198050","72","338771","141748","197023","71.9",
"충청남도","65세이상","2017 년","354018","149131","204887","72.8","351942","148197","203745","72.7",
"충청남도","65세이상","2018 년","363156","153781","209375","73.4","360754","152738","208016","73.4",
"충청남도","65세이상","2019 년","376534","160426","216108","74.2","373686","159171","214515","74.2",
"충청남도","65세이상","2020 년","395148","169745","225403","75.3","391992","168427","223565","75.3",
"충청남도","65세이상","2021 년","411342","178147","233195","76.4","407831","176686","231145","76.4",
"충청남도","65세이상","2022 년","428902","187564","241338","77.7","424607","185758","238849","77.8",
"충청남도","65세이상","2023 년","446264","196461","249803","78.6","441235","194403","246832","78.8",
"충청남도","85세이상","2015 년","30809","8389","22420","37.4","30741","8367","22374","37.4",
"충청남도","85세이상","2016 년","32857","8886","23971","37.1","32779","8861","23918","37",
"충청남도","85세이상","2017 년","36753","10150","26603","38.2","36687","10132","26555","38.2",
"충청남도","85세이상","2018 년","40293","11301","28992","39","40226","11283","28943","39",
"충청남도","85세이상","2019 년","44235","12719","31516","40.4","44127","12675","31452","40.3",
"충청남도","85세이상","2020 년","49034","14184","34850","40.7","48936","14149","34787","40.7",
"충청남도","85세이상","2021 년","53672","15767","37905","41.6","53571","15735","37836","41.6",
"충청남도","85세이상","2022 년","56855","16770","40085","41.8","56729","16732","39997","41.8",
"충청남도","85세이상","2023 년","60128","17675","42453","41.6","59949","17631","42318","41.7",
"충청남도","평균연령","2015 년","41.1","39.7","42.6","","41.2","39.8","42.7","",
"충청남도","평균연령","2016 년","41.5","40.1","42.9","","41.6","40.2","43.1","",
"충청남도","평균연령","2017 년","41.9","40.5","43.3","","42.1","40.7","43.5","",
"충청남도","평균연령","2018 년","42.3","40.9","43.8","","42.6","41.2","44","",
"충청남도","평균연령","2019 년","42.8","41.4","44.3","","43.1","41.8","44.6","",
"충청남도","평균연령","2020 년","43.5","42.1","45","","43.8","42.4","45.3","",
"충청남도","평균연령","2021 년","44.1","42.8","45.6","","44.4","43.1","45.9","",
"충청남도","평균연령","2022 년","44.6","43.2","46","","44.9","43.6","46.4","",
"충청남도","평균연령","2023 년","45","43.6","46.5","","45.5","44.2","46.9","",
"충청남도","중위연령","2015 년","41.3","39.8","42.8","","41.6","40.3","43.1","",
"충청남도","중위연령","2016 년","41.7","40.3","43.3","","42.2","40.8","43.6","",
"충청남도","중위연령","2017 년","42.2","40.7","43.9","","42.8","41.3","44.2","",
"충청남도","중위연령","2018 년","42.7","41.2","44.5","","43.4","41.9","44.9","",
"충청남도","중위연령","2019 년","43.4","41.8","45.1","","44.1","42.6","45.7","",
"충청남도","중위연령","2020 년","44.3","42.7","46.1","","45","43.5","46.6","",
"충청남도","중위연령","2021 년","45","43.5","46.8","","45.8","44.3","47.4","",
"충청남도","중위연령","2022 년","45.5","43.9","47.4","","46.4","44.9","48","",
"충청남도","중위연령","2023 년","46","44.4","48","","47.1","45.6","48.8","",
"전라북도","합계","2015 년","1834114","915729","918385","99.7","1804184","899308","904876","99.4",
"전라북도","합계","2016 년","1833168","915493","917675","99.8","1801619","898232","903387","99.4",
"전라북도","합계","2017 년","1826174","911592","914582","99.7","1792410","893346","899064","99.4",
"전라북도","합계","2018 년","1818157","907683","910474","99.7","1779026","886532","892494","99.3",
"전라북도","합계","2019 년","1807423","902704","904719","99.8","1763463","878627","884836","99.3",
"전라북도","합계","2020 년","1802766","899058","903708","99.5","1760400","876451","883949","99.2",
"전라북도","합계","2021 년","1787053","891295","895758","99.5","1746006","869614","876392","99.2",
"전라북도","합계","2022 년","1774248","885708","888540","99.7","1729520","861385","868135","99.2",
"전라북도","합계","2023 년","1768491","884098","884393","100","1715692","854648","861044","99.3",
"전라북도","0~4세","2015 년","76068","39071","36997","105.6","75762","38909","36853","105.6",
"전라북도","0~4세","2016 년","73369","37751","35618","106","73054","37585","35469","106",
"전라북도","0~4세","2017 년","68290","35118","33172","105.9","68023","34967","33056","105.8",
"전라북도","0~4세","2018 년","63571","32573","30998","105.1","63211","32378","30833","105",
"전라북도","0~4세","2019 년","58372","29799","28573","104.3","57948","29558","28390","104.1",
"전라북도","0~4세","2020 년","52412","26759","25653","104.3","52011","26545","25466","104.2",
"전라북도","0~4세","2021 년","47000","23980","23020","104.2","46614","23772","22842","104.1",
"전라북도","0~4세","2022 년","42850","21718","21132","102.8","42461","21514","20947","102.7",
"전라북도","0~4세","2023 년","39476","19965","19511","102.3","39066","19768","19298","102.4",
"전라북도","5~9세","2015 년","79366","41026","38340","107","79145","40921","38224","107.1",
"전라북도","5~9세","2016 년","80588","41516","39072","106.3","80342","41395","38947","106.3",
"전라북도","5~9세","2017 년","80210","41274","38936","106","80043","41192","38851","106",
"전라북도","5~9세","2018 년","78863","40614","38249","106.2","78701","40523","38178","106.1",
"전라북도","5~9세","2019 년","77840","40091","37749","106.2","77587","39949","37638","106.1",
"전라북도","5~9세","2020 년","76371","39287","37084","105.9","76132","39150","36982","105.9",
"전라북도","5~9세","2021 년","73014","37641","35373","106.4","72722","37472","35250","106.3",
"전라북도","5~9세","2022 년","67947","35007","32940","106.3","67598","34811","32787","106.2",
"전라북도","5~9세","2023 년","63168","32426","30742","105.5","62855","32254","30601","105.4",
"전라북도","10~14세","2015 년","91063","47228","43835","107.7","90904","47145","43759","107.7",
"전라북도","10~14세","2016 년","84666","44064","40602","108.5","84513","43980","40533","108.5",
"전라북도","10~14세","2017 년","82865","42971","39894","107.7","82765","42923","39842","107.7",
"전라북도","10~14세","2018 년","81024","42056","38968","107.9","80918","42004","38914","107.9",
"전라북도","10~14세","2019 년","79205","41082","38123","107.8","79071","41016","38055","107.8",
"전라북도","10~14세","2020 년","80415","41570","38845","107","80274","41500","38774","107",
"전라북도","10~14세","2021 년","81088","41788","39300","106.3","80909","41694","39215","106.3",
"전라북도","10~14세","2022 년","80321","41314","39007","105.9","80108","41207","38901","105.9",
"전라북도","10~14세","2023 년","78833","40553","38280","105.9","78622","40451","38171","106",
"전라북도","15~19세","2015 년","123926","65504","58422","112.1","123405","65248","58157","112.2",
"전라북도","15~19세","2016 년","120958","63887","57071","111.9","120269","63533","56736","112",
"전라북도","15~19세","2017 년","114829","60874","53955","112.8","113587","60244","53343","112.9",
"전라북도","15~19세","2018 년","108439","57444","50995","112.6","106984","56674","50310","112.6",
"전라북도","15~19세","2019 년","101942","53956","47986","112.4","100447","53146","47301","112.4",
"전라북도","15~19세","2020 년","93811","49481","44330","111.6","92961","49060","43901","111.8",
"전라북도","15~19세","2021 년","87145","46109","41036","112.4","86407","45715","40692","112.3",
"전라북도","15~19세","2022 년","86048","45376","40672","111.6","84714","44681","40033","111.6",
"전라북도","15~19세","2023 년","84259","44490","39769","111.9","82756","43747","39009","112.1",
"전라북도","20~24세","2015 년","126300","69322","56978","121.7","121426","66926","54500","122.8",
"전라북도","20~24세","2016 년","128596","70624","57972","121.8","123315","68071","55244","123.2",
"전라북도","20~24세","2017 년","128067","70721","57346","123.3","122021","67646","54375","124.4",
"전라북도","20~24세","2018 년","128024","71071","56953","124.8","120249","66772","53477","124.9",
"전라북도","20~24세","2019 년","124548","69242","55306","125.2","115976","64325","51651","124.5",
"전라북도","20~24세","2020 년","123972","68339","55633","122.8","115947","63789","52158","122.3",
"전라북도","20~24세","2021 년","118283","65327","52956","123.4","110932","61234","49698","123.2",
"전라북도","20~24세","2022 년","111284","61905","49379","125.4","103959","57812","46147","125.3",
"전라북도","20~24세","2023 년","105732","58718","47014","124.9","97500","54062","43438","124.5",
"전라북도","25~29세","2015 년","97765","52875","44890","117.8","91510","49196","42314","116.3",
"전라북도","25~29세","2016 년","97731","52950","44781","118.2","91187","49076","42111","116.5",
"전라북도","25~29세","2017 년","99015","53533","45482","117.7","92330","49674","42656","116.5",
"전라북도","25~29세","2018 년","100946","54850","46096","119","93335","50492","42843","117.9",
"전라북도","25~29세","2019 년","103749","56701","47048","120.5","95285","51837","43448","119.3",
"전라북도","25~29세","2020 년","105427","57718","47709","121","97122","53007","44115","120.2",
"전라북도","25~29세","2021 년","106105","58432","47673","122.6","98188","53878","44310","121.6",
"전라북도","25~29세","2022 년","105436","58230","47206","123.4","96505","52892","43613","121.3",
"전라북도","25~29세","2023 년","105782","58649","47133","124.4","95258","52202","43056","121.2",
"전라북도","30~34세","2015 년","109359","57328","52031","110.2","104691","54419","50272","108.2",
"전라북도","30~34세","2016 년","103957","54309","49648","109.4","98994","51287","47707","107.5",
"전라북도","30~34세","2017 년","97034","50645","46389","109.2","91748","47482","44266","107.3",
"전라북도","30~34세","2018 년","92655","48275","44380","108.8","86260","44536","41724","106.7",
"전라북도","30~34세","2019 년","89313","46712","42601","109.7","82318","42643","39675","107.5",
"전라북도","30~34세","2020 년","88247","46489","41758","111.3","81111","42377","38734","109.4",
"전라북도","30~34세","2021 년","87868","46480","41388","112.3","80983","42590","38393","110.9",
"전라북도","30~34세","2022 년","90187","48108","42079","114.3","82598","43628","38970","112",
"전라북도","30~34세","2023 년","93676","50508","43168","117","84470","44874","39596","113.3",
"전라북도","35~39세","2015 년","120792","62471","58321","107.1","117846","60600","57246","105.9",
"전라북도","35~39세","2016 년","120642","62417","58225","107.2","117433","60431","57002","106",
"전라북도","35~39세","2017 년","120108","62003","58105","106.7","116625","59943","56682","105.8",
"전라북도","35~39세","2018 년","118600","61118","57482","106.3","114323","58725","55598","105.6",
"전라북도","35~39세","2019 년","114218","58694","55524","105.7","109269","55986","53283","105.1",
"전라북도","35~39세","2020 년","107281","55044","52237","105.4","102185","52268","49917","104.7",
"전라북도","35~39세","2021 년","101130","51697","49433","104.6","96120","49013","47107","104",
"전라북도","35~39세","2022 년","94712","48683","46029","105.8","89067","45519","43548","104.5",
"전라북도","35~39세","2023 년","90756","46899","43857","106.9","83756","42744","41012","104.2",
"전라북도","40~44세","2015 년","143138","74161","68977","107.5","140823","72828","67995","107.1",
"전라북도","40~44세","2016 년","136336","70471","65865","107","134006","69142","64864","106.6",
"전라북도","40~44세","2017 년","131711","67634","64077","105.6","129326","66308","63018","105.2",
"전라북도","40~44세","2018 년","125991","64585","61406","105.2","123220","63137","60083","105.1",
"전라북도","40~44세","2019 년","120833","61886","58947","105","117525","60152","57373","104.8",
"전라북도","40~44세","2020 년","120614","61651","58963","104.6","117182","59881","57301","104.5",
"전라북도","40~44세","2021 년","119858","61185","58673","104.3","116363","59426","56937","104.4",
"전라북도","40~44세","2022 년","119659","61091","58568","104.3","115803","59056","56747","104.1",
"전라북도","40~44세","2023 년","118867","60845","58022","104.9","114158","58336","55822","104.5",
"전라북도","45~49세","2015 년","146666","75918","70748","107.3","144419","74826","69593","107.5",
"전라북도","45~49세","2016 년","149650","77422","72228","107.2","147359","76262","71097","107.3",
"전라북도","45~49세","2017 년","150192","77962","72230","107.9","147780","76754","71026","108.1",
"전라북도","45~49세","2018 년","148594","76927","71667","107.3","146033","75651","70382","107.5",
"전라북도","45~49세","2019 년","147802","76470","71332","107.2","144933","75035","69898","107.3",
"전라북도","45~49세","2020 년","143786","74113","69673","106.4","141239","72939","68300","106.8",
"전라북도","45~49세","2021 년","136383","69943","66440","105.3","133848","68767","65081","105.7",
"전라북도","45~49세","2022 년","132136","67424","64712","104.2","129596","66272","63324","104.7",
"전라북도","45~49세","2023 년","126891","64831","62060","104.5","123870","63425","60445","104.9",
"전라북도","50~54세","2015 년","145400","74578","70822","105.3","143272","73628","69644","105.7",
"전라북도","50~54세","2016 년","141728","73288","68440","107.1","139518","72249","67269","107.4",
"전라북도","50~54세","2017 년","140178","72239","67939","106.3","137980","71221","66759","106.7",
"전라북도","50~54세","2018 년","142504","73368","69136","106.1","140365","72421","67944","106.6",
"전라북도","50~54세","2019 년","146460","75420","71040","106.2","143988","74225","69763","106.4",
"전라북도","50~54세","2020 년","148011","76304","71707","106.4","145776","75336","70440","107",
"전라북도","50~54세","2021 년","150432","77417","73015","106","148238","76461","71777","106.5",
"전라북도","50~54세","2022 년","150934","78015","72919","107","148643","76980","71663","107.4",
"전라북도","50~54세","2023 년","150209","77538","72671","106.7","147459","76234","71225","107",
"전라북도","55~59세","2015 년","141381","70761","70620","100.2","139815","70022","69793","100.3",
"전라북도","55~59세","2016 년","148028","73974","74054","99.9","146522","73283","73239","100.1",
"전라북도","55~59세","2017 년","150771","75531","75240","100.4","149229","74847","74382","100.6",
"전라북도","55~59세","2018 년","152161","76491","75670","101.1","150558","75790","74768","101.4",
"전라북도","55~59세","2019 년","149653","75865","73788","102.8","147775","74960","72815","102.9",
"전라북도","55~59세","2020 년","145176","74026","71150","104","143414","73281","70133","104.5",
"전라북도","55~59세","2021 년","141576","72797","68779","105.8","139749","72019","67730","106.3",
"전라북도","55~59세","2022 년","140738","72149","68589","105.2","138896","71340","67556","105.6",
"전라북도","55~59세","2023 년","143957","73731","70226","105","141827","72795","69032","105.5",
"전라북도","60~64세","2015 년","108527","53536","54991","97.4","107614","53098","54516","97.4",
"전라북도","60~64세","2016 년","114907","56920","57987","98.2","113955","56446","57509","98.2",
"전라북도","60~64세","2017 년","120983","60096","60887","98.7","119906","59575","60331","98.7",
"전라북도","60~64세","2018 년","128339","63900","64439","99.2","127277","63395","63882","99.2",
"전라북도","60~64세","2019 년","133798","66591","67207","99.1","132659","66054","66605","99.2",
"전라북도","60~64세","2020 년","141250","70209","71041","98.8","140085","69686","70399","99",
"전라북도","60~64세","2021 년","148521","73674","74847","98.4","147379","73207","74172","98.7",
"전라북도","60~64세","2022 년","150482","74799","75683","98.8","149263","74303","74960","99.1",
"전라북도","60~64세","2023 년","153073","76572","76501","100.1","151668","75965","75703","100.3",
"전라북도","65~69세","2015 년","95361","45682","49679","92","94955","45466","49489","91.9",
"전라북도","65~69세","2016 년","97553","46831","50722","92.3","97098","46605","50493","92.3",
"전라북도","65~69세","2017 년","97786","46997","50789","92.5","97319","46757","50562","92.5",
"전라북도","65~69세","2018 년","97155","46717","50438","92.6","96706","46511","50195","92.7",
"전라북도","65~69세","2019 년","100965","48900","52065","93.9","100445","48648","51797","93.9",
"전라북도","65~69세","2020 년","106800","51870","54930","94.4","106269","51626","54643","94.5",
"전라북도","65~69세","2021 년","112693","54915","57778","95","112133","54649","57484","95.1",
"전라북도","65~69세","2022 년","118801","58301","60500","96.4","118151","57996","60155","96.4",
"전라북도","65~69세","2023 년","126201","62062","64139","96.8","125489","61742","63747","96.9",
"전라북도","70~74세","2015 년","82369","35424","46945","75.5","82176","35329","46847","75.4",
"전라북도","70~74세","2016 년","81216","35692","45524","78.4","81006","35593","45413","78.4",
"전라북도","70~74세","2017 년","78718","35658","43060","82.8","78503","35554","42949","82.8",
"전라북도","70~74세","2018 년","81196","37408","43788","85.4","80965","37298","43667","85.4",
"전라북도","70~74세","2019 년","84975","39365","45610","86.3","84706","39247","45459","86.3",
"전라북도","70~74세","2020 년","91573","42731","48842","87.5","91291","42617","48674","87.6",
"전라북도","70~74세","2021 년","93950","43946","50004","87.9","93655","43834","49821","88",
"전라북도","70~74세","2022 년","94089","44120","49969","88.3","93799","43997","49802","88.3",
"전라북도","70~74세","2023 년","93842","44072","49770","88.6","93509","43938","49571","88.6",
"전라북도","75~79세","2015 년","70038","27401","42637","64.3","69919","27351","42568","64.3",
"전라북도","75~79세","2016 년","71315","28124","43191","65.1","71207","28083","43124","65.1",
"전라북도","75~79세","2017 년","78204","31139","47065","66.2","78104","31105","46999","66.2",
"전라북도","75~79세","2018 년","77832","31280","46552","67.2","77741","31256","46485","67.2",
"전라북도","75~79세","2019 년","75849","30719","45130","68.1","75742","30681","45061","68.1",
"전라북도","75~79세","2020 년","74973","30672","44301","69.2","74864","30626","44238","69.2",
"전라북도","75~79세","2021 년","74278","31124","43154","72.1","74159","31074","43085","72.1",
"전라북도","75~79세","2022 년","72335","31425","40910","76.8","72193","31371","40822","76.8",
"전라북도","75~79세","2023 년","74684","33073","41611","79.5","74505","32998","41507","79.5",
"전라북도","80~84세","2015 년","46991","15777","31214","50.5","46940","15751","31189","50.5",
"전라북도","80~84세","2016 년","49965","17066","32899","51.9","49915","17041","32874","51.8",
"전라북도","80~84세","2017 년","52557","18276","34281","53.3","52491","18246","34245","53.3",
"전라북도","80~84세","2018 년","54685","19171","35514","54","54628","19149","35479","54",
"전라북도","80~84세","2019 년","56799","20255","36544","55.4","56730","20229","36501","55.4",
"전라북도","80~84세","2020 년","57322","20539","36783","55.8","57245","20521","36724","55.9",
"전라북도","80~84세","2021 년","58681","21334","37347","57.1","58602","21317","37285","57.2",
"전라북도","80~84세","2022 년","64916","23801","41115","57.9","64836","23778","41058","57.9",
"전라북도","80~84세","2023 년","64794","23981","40813","58.8","64701","23951","40750","58.8",
"전라북도","85~89세","2015 년","21550","5919","15631","37.9","21524","5909","15615","37.8",
"전라북도","85~89세","2016 년","23326","6319","17007","37.2","23304","6310","16994","37.1",
"전라북도","85~89세","2017 년","24932","6794","18138","37.5","24911","6784","18127","37.4",
"전라북도","85~89세","2018 년","26724","7481","19243","38.9","26702","7468","19234","38.8",
"전라북도","85~89세","2019 년","29195","8315","20880","39.8","29168","8298","20870","39.8",
"전라북도","85~89세","2020 년","32039","9408","22631","41.6","32016","9396","22620","41.5",
"전라북도","85~89세","2021 년","34528","10354","24174","42.8","34499","10344","24155","42.8",
"전라북도","85~89세","2022 년","35980","10931","25049","43.6","35948","10922","25026","43.6",
"전라북도","85~89세","2023 년","37595","11561","26034","44.4","37544","11546","25998","44.4",
"전라북도","90~94세","2015 년","6483","1510","4973","30.4","6471","1501","4970","30.2",
"전라북도","90~94세","2016 년","6883","1586","5297","29.9","6873","1580","5293","29.9",
"전라북도","90~94세","2017 년","7685","1775","5910","30","7681","1772","5909","30",
"전라북도","90~94세","2018 년","8587","1971","6616","29.8","8583","1969","6614","29.8",
"전라북도","90~94세","2019 년","9625","2232","7393","30.2","9612","2229","7383","30.2",
"전라북도","90~94세","2020 년","10844","2423","8421","28.8","10836","2422","8414","28.8",
"전라북도","90~94세","2021 년","11949","2706","9243","29.3","11938","2703","9235","29.3",
"전라북도","90~94세","2022 년","12553","2841","9712","29.3","12544","2837","9707","29.2",
"전라북도","90~94세","2023 년","13515","3099","10416","29.8","13501","3091","10410","29.7",
"전라북도","95~99세","2015 년","1420","222","1198","18.5","1416","220","1196","18.4",
"전라북도","95~99세","2016 년","1570","256","1314","19.5","1566","254","1312","19.4",
"전라북도","95~99세","2017 년","1828","325","1503","21.6","1828","325","1503","21.6",
"전라북도","95~99세","2018 년","2021","347","1674","20.7","2021","347","1674","20.7",
"전라북도","95~99세","2019 년","2007","366","1641","22.3","2005","366","1639","22.3",
"전라북도","95~99세","2020 년","2118","383","1735","22.1","2117","382","1735","22",
"전라북도","95~99세","2021 년","2214","400","1814","22.1","2212","399","1813","22",
"전라북도","95~99세","2022 년","2438","418","2020","20.7","2437","417","2020","20.6",
"전라북도","95~99세","2023 년","2778","477","2301","20.7","2776","477","2299","20.7",
"전라북도","100세이상","2015 년","151","15","136","11","151","15","136","11",
"전라북도","100세이상","2016 년","184","26","158","16.5","183","26","157","16.6",
"전라북도","100세이상","2017 년","211","27","184","14.7","210","27","183","14.8",
"전라북도","100세이상","2018 년","246","36","210","17.1","246","36","210","17.1",
"전라북도","100세이상","2019 년","275","43","232","18.5","274","43","231","18.6",
"전라북도","100세이상","2020 년","324","42","282","14.9","323","42","281","14.9",
"전라북도","100세이상","2021 년","357","46","311","14.8","356","46","310","14.8",
"전라북도","100세이상","2022 년","402","52","350","14.9","401","52","349","14.9",
"전라북도","100세이상","2023 년","403","48","355","13.5","402","48","354","13.6",
"전라북도","15세미만","2015 년","246497","127325","119172","106.8","245811","126975","118836","106.8",
"전라북도","15세미만","2016 년","238623","123331","115292","107","237909","122960","114949","107",
"전라북도","15세미만","2017 년","231365","119363","112002","106.6","230831","119082","111749","106.6",
"전라북도","15세미만","2018 년","223458","115243","108215","106.5","222830","114905","107925","106.5",
"전라북도","15세미만","2019 년","215417","110972","104445","106.2","214606","110523","104083","106.2",
"전라북도","15세미만","2020 년","209198","107616","101582","105.9","208417","107195","101222","105.9",
"전라북도","15세미만","2021 년","201102","103409","97693","105.9","200245","102938","97307","105.8",
"전라북도","15세미만","2022 년","191118","98039","93079","105.3","190167","97532","92635","105.3",
"전라북도","15세미만","2023 년","181477","92944","88533","105","180543","92473","88070","105",
"전라북도","15~64세","2015 년","1263254","656454","606800","108.2","1234821","640791","594030","107.9",
"전라북도","15~64세","2016 년","1262533","656262","606271","108.2","1232558","639780","592778","107.9",
"전라북도","15~64세","2017 년","1252888","651238","601650","108.2","1220532","633694","586838","108",
"전라북도","15~64세","2018 년","1246253","648029","598224","108.3","1208604","627593","581011","108",
"전라북도","15~64세","2019 년","1232316","641537","590779","108.6","1190175","618363","571812","108.1",
"전라북도","15~64세","2020 년","1217575","633374","584201","108.4","1177022","611624","565398","108.2",
"전라북도","15~64세","2021 년","1197301","623061","574240","108.5","1158207","602310","555897","108.3",
"전라북도","15~64세","2022 년","1181616","615780","565836","108.8","1139044","592483","546561","108.4",
"전라북도","15~64세","2023 년","1173202","612781","560421","109.3","1122722","584384","538338","108.6",
"전라북도","65세이상","2015 년","324363","131950","192413","68.6","323552","131542","192010","68.5",
"전라북도","65세이상","2016 년","332012","135900","196112","69.3","331152","135492","195660","69.2",
"전라북도","65세이상","2017 년","341921","140991","200930","70.2","341047","140570","200477","70.1",
"전라북도","65세이상","2018 년","348446","144411","204035","70.8","347592","144034","203558","70.8",
"전라북도","65세이상","2019 년","359690","150195","209495","71.7","358682","149741","208941","71.7",
"전라북도","65세이상","2020 년","375993","158068","217925","72.5","374961","157632","217329","72.5",
"전라북도","65세이상","2021 년","388650","164825","223825","73.6","387554","164366","223188","73.6",
"전라북도","65세이상","2022 년","401514","171889","229625","74.9","400309","171370","228939","74.9",
"전라북도","65세이상","2023 년","413812","178373","235439","75.8","412427","177791","234636","75.8",
"전라북도","85세이상","2015 년","29604","7666","21938","34.9","29562","7645","21917","34.9",
"전라북도","85세이상","2016 년","31963","8187","23776","34.4","31926","8170","23756","34.4",
"전라북도","85세이상","2017 년","34656","8921","25735","34.7","34630","8908","25722","34.6",
"전라북도","85세이상","2018 년","37578","9835","27743","35.5","37552","9820","27732","35.4",
"전라북도","85세이상","2019 년","41102","10956","30146","36.3","41059","10936","30123","36.3",
"전라북도","85세이상","2020 년","45325","12256","33069","37.1","45292","12242","33050","37",
"전라북도","85세이상","2021 년","49048","13506","35542","38","49005","13492","35513","38",
"전라북도","85세이상","2022 년","51373","14242","37131","38.4","51330","14228","37102","38.3",
"전라북도","85세이상","2023 년","54291","15185","39106","38.8","54223","15162","39061","38.8",
"전라북도","평균연령","2015 년","42.3","40.6","44","","42.4","40.7","44.1","",
"전라북도","평균연령","2016 년","42.8","41.1","44.5","","42.9","41.2","44.6","",
"전라북도","평균연령","2017 년","43.3","41.6","45","","43.5","41.8","45.2","",
"전라북도","평균연령","2018 년","43.9","42.2","45.6","","44.1","42.4","45.8","",
"전라북도","평균연령","2019 년","44.5","42.8","46.2","","44.7","43","46.4","",
"전라북도","평균연령","2020 년","45.1","43.4","46.8","","45.3","43.6","47","",
"전라북도","평균연령","2021 년","45.7","44","47.4","","46","44.3","47.7","",
"전라북도","평균연령","2022 년","46.3","44.6","48","","46.6","44.9","48.3","",
"전라북도","평균연령","2023 년","46.9","45.2","48.5","","47.2","45.6","48.9","",
"전라북도","중위연령","2015 년","43.3","41.7","45","","43.5","41.9","45.2","",
"전라북도","중위연령","2016 년","43.9","42.3","45.7","","44.2","42.6","45.9","",
"전라북도","중위연령","2017 년","44.7","43.1","46.4","","45","43.4","46.7","",
"전라북도","중위연령","2018 년","45.4","43.7","47.1","","45.8","44.2","47.5","",
"전라북도","중위연령","2019 년","46.2","44.5","47.9","","46.6","45","48.3","",
"전라북도","중위연령","2020 년","46.9","45.2","48.6","","47.4","45.8","49.1","",
"전라북도","중위연령","2021 년","47.8","46","49.5","","48.2","46.6","49.9","",
"전라북도","중위연령","2022 년","48.5","46.7","50.2","","49","47.4","50.7","",
"전라북도","중위연령","2023 년","49.2","47.4","50.9","","49.8","48.2","51.4","",
"전라남도","합계","2015 년","1799044","900967","898077","100.3","1764433","879860","884573","99.5",
"전라남도","합계","2016 년","1796017","901500","894517","100.8","1759387","879099","880288","99.9",
"전라남도","합계","2017 년","1792319","899077","893242","100.7","1755107","876537","878570","99.8",
"전라남도","합계","2018 년","1790352","900154","890198","101.1","1747832","874149","873683","100.1",
"전라남도","합계","2019 년","1787543","901813","885730","101.8","1739765","872070","867695","100.5",
"전라남도","합계","2020 년","1788807","903281","885526","102","1743571","875732","867839","100.9",
"전라남도","합계","2021 년","1778124","897120","881004","101.8","1733965","870400","863565","100.8",
"전라남도","합계","2022 년","1771431","896174","875257","102.4","1721873","864610","857263","100.9",
"전라남도","합계","2023 년","1776668","903776","872892","103.5","1714175","862083","852092","101.2",
"전라남도","0~4세","2015 년","77187","39185","38002","103.1","76969","39080","37889","103.1",
"전라남도","0~4세","2016 년","74841","38156","36685","104","74620","38040","36580","104",
"전라남도","0~4세","2017 년","70463","36156","34307","105.4","70290","36064","34226","105.4",
"전라남도","0~4세","2018 년","65729","33631","32098","104.8","65542","33539","32003","104.8",
"전라남도","0~4세","2019 년","61430","31393","30037","104.5","61206","31274","29932","104.5",
"전라남도","0~4세","2020 년","56489","28953","27536","105.1","56268","28846","27422","105.2",
"전라남도","0~4세","2021 년","51335","26251","25084","104.7","51080","26119","24961","104.6",
"전라남도","0~4세","2022 년","47202","24063","23139","104","46937","23917","23020","103.9",
"전라남도","0~4세","2023 년","44134","22407","21727","103.1","43859","22265","21594","103.1",
"전라남도","5~9세","2015 년","75143","38749","36394","106.5","74980","38671","36309","106.5",
"전라남도","5~9세","2016 년","77182","39664","37518","105.7","76991","39568","37423","105.7",
"전라남도","5~9세","2017 년","77847","39799","38048","104.6","77707","39735","37972","104.6",
"전라남도","5~9세","2018 년","77366","39559","37807","104.6","77246","39505","37741","104.7",
"전라남도","5~9세","2019 년","76356","38929","37427","104","76181","38845","37336","104",
"전라남도","5~9세","2020 년","75394","38270","37124","103.1","75225","38187","37038","103.1",
"전라남도","5~9세","2021 년","72690","36956","35734","103.4","72453","36849","35604","103.5",
"전라남도","5~9세","2022 년","67984","34858","33126","105.2","67721","34734","32987","105.3",
"전라남도","5~9세","2023 년","63584","32600","30984","105.2","63355","32478","30877","105.2",
"전라남도","10~14세","2015 년","84937","44324","40613","109.1","84838","44270","40568","109.1",
"전라남도","10~14세","2016 년","79137","41058","38079","107.8","79019","41000","38019","107.8",
"전라남도","10~14세","2017 년","77604","40141","37463","107.1","77504","40090","37414","107.2",
"전라남도","10~14세","2018 년","76336","39451","36885","107","76224","39391","36833","106.9",
"전라남도","10~14세","2019 년","74812","38532","36280","106.2","74669","38459","36210","106.2",
"전라남도","10~14세","2020 년","76877","39661","37216","106.6","76753","39611","37142","106.6",
"전라남도","10~14세","2021 년","78516","40360","38156","105.8","78365","40299","38066","105.9",
"전라남도","10~14세","2022 년","78612","40219","38393","104.8","78427","40125","38302","104.8",
"전라남도","10~14세","2023 년","77942","39955","37987","105.2","77740","39848","37892","105.2",
"전라남도","15~19세","2015 년","111028","58971","52057","113.3","110630","58786","51844","113.4",
"전라남도","15~19세","2016 년","107750","57555","50195","114.7","107285","57327","49958","114.8",
"전라남도","15~19세","2017 년","101276","54087","47189","114.6","100754","53845","46909","114.8",
"전라남도","15~19세","2018 년","95929","51413","44516","115.5","95089","50960","44129","115.5",
"전라남도","15~19세","2019 년","89719","48107","41612","115.6","88939","47680","41259","115.6",
"전라남도","15~19세","2020 년","82241","44067","38174","115.4","81864","43879","37985","115.5",
"전라남도","15~19세","2021 년","76785","40819","35966","113.5","76376","40588","35788","113.4",
"전라남도","15~19세","2022 년","75057","39867","35190","113.3","74312","39440","34872","113.1",
"전라남도","15~19세","2023 년","74094","39152","34942","112","72941","38451","34490","111.5",
"전라남도","20~24세","2015 년","99301","57132","42169","135.5","93986","53959","40027","134.8",
"전라남도","20~24세","2016 년","101073","58731","42342","138.7","95427","55215","40212","137.3",
"전라남도","20~24세","2017 년","99316","58188","41128","141.5","93977","54839","39138","140.1",
"전라남도","20~24세","2018 년","100089","58859","41230","142.8","94154","55034","39120","140.7",
"전라남도","20~24세","2019 년","98558","58143","40415","143.9","92121","53950","38171","141.3",
"전라남도","20~24세","2020 년","97640","57331","40309","142.2","92307","53942","38365","140.6",
"전라남도","20~24세","2021 년","91569","54046","37523","144","87062","51286","35776","143.4",
"전라남도","20~24세","2022 년","85505","50732","34773","145.9","80610","47380","33230","142.6",
"전라남도","20~24세","2023 년","81356","48916","32440","150.8","74844","44258","30586","144.7",
"전라남도","25~29세","2015 년","83731","45144","38587","117","75927","40163","35764","112.3",
"전라남도","25~29세","2016 년","84706","46084","38622","119.3","76435","40700","35735","113.9",
"전라남도","25~29세","2017 년","85448","46344","39104","118.5","76918","40729","36189","112.5",
"전라남도","25~29세","2018 년","89241","49052","40189","122.1","79527","42528","36999","114.9",
"전라남도","25~29세","2019 년","93860","52690","41170","128","83292","45384","37908","119.7",
"전라남도","25~29세","2020 년","96754","55301","41453","133.4","86664","48333","38331","126.1",
"전라남도","25~29세","2021 년","96458","55084","41374","133.1","87269","48745","38524","126.5",
"전라남도","25~29세","2022 년","97569","56379","41190","136.9","87050","48765","38285","127.4",
"전라남도","25~29세","2023 년","99022","57790","41232","140.2","86258","48147","38111","126.3",
"전라남도","30~34세","2015 년","103927","55536","48391","114.8","98162","51591","46571","110.8",
"전라남도","30~34세","2016 년","99547","52943","46604","113.6","93402","48828","44574","109.5",
"전라남도","30~34세","2017 년","92737","48937","43800","111.7","86282","44737","41545","107.7",
"전라남도","30~34세","2018 년","87812","46449","41363","112.3","80139","41508","38631","107.4",
"전라남도","30~34세","2019 년","85624","45848","39776","115.3","76911","40159","36752","109.3",
"전라남도","30~34세","2020 년","84693","45672","39021","117","75955","39947","36008","110.9",
"전라남도","30~34세","2021 년","83905","45424","38481","118","75116","39663","35453","111.9",
"전라남도","30~34세","2022 년","86907","47867","39040","122.6","76797","40779","36018","113.2",
"전라남도","30~34세","2023 년","93156","52331","40825","128.2","79953","42701","37252","114.6",
"전라남도","35~39세","2015 년","113927","60234","53693","112.2","110192","57649","52543","109.7",
"전라남도","35~39세","2016 년","114648","60637","54011","112.3","110555","57811","52744","109.6",
"전라남도","35~39세","2017 년","116128","61550","54578","112.8","111710","58617","53093","110.4",
"전라남도","35~39세","2018 년","116372","61577","54795","112.4","110994","58082","52912","109.8",
"전라남도","35~39세","2019 년","112547","59756","52791","113.2","106345","55787","50558","110.3",
"전라남도","35~39세","2020 년","106686","56818","49868","113.9","100239","52744","47495","111.1",
"전라남도","35~39세","2021 년","100987","53497","47490","112.6","94367","49316","45051","109.5",
"전라남도","35~39세","2022 년","94443","50045","44398","112.7","86917","45135","41782","108",
"전라남도","35~39세","2023 년","91384","49021","42363","115.7","81646","42378","39268","107.9",
"전라남도","40~44세","2015 년","133103","71313","61790","115.4","129982","69252","60730","114",
"전라남도","40~44세","2016 년","126353","67487","58866","114.6","123211","65457","57754","113.3",
"전라남도","40~44세","2017 년","122230","64817","57413","112.9","119143","62868","56275","111.7",
"전라남도","40~44세","2018 년","117596","62349","55247","112.9","113944","60098","53846","111.6",
"전라남도","40~44세","2019 년","115357","61069","54288","112.5","111174","58494","52680","111",
"전라남도","40~44세","2020 년","116437","61549","54888","112.1","112313","59108","53205","111.1",
"전라남도","40~44세","2021 년","116676","61473","55203","111.4","112433","58924","53509","110.1",
"전라남도","40~44세","2022 년","117945","62443","55502","112.5","113152","59516","53636","111",
"전라남도","40~44세","2023 년","119301","63359","55942","113.3","113037","59347","53690","110.5",
"전라남도","45~49세","2015 년","144423","77553","66870","116","141765","76170","65595","116.1",
"전라남도","45~49세","2016 년","145244","77597","67647","114.7","142563","76210","66353","114.9",
"전라남도","45~49세","2017 년","144949","77420","67529","114.6","142166","75950","66216","114.7",
"전라남도","45~49세","2018 년","142245","75738","66507","113.9","139239","74132","65107","113.9",
"전라남도","45~49세","2019 년","140542","75064","65478","114.6","137121","73159","63962","114.4",
"전라남도","45~49세","2020 년","136028","72514","63514","114.2","132935","70861","62074","114.2",
"전라남도","45~49세","2021 년","129210","68669","60541","113.4","126141","67019","59122","113.4",
"전라남도","45~49세","2022 년","125181","66111","59070","111.9","121994","64386","57608","111.8",
"전라남도","45~49세","2023 년","121073","64189","56884","112.8","117181","61989","55192","112.3",
"전라남도","50~54세","2015 년","145762","76357","69405","110","143521","75333","68188","110.5",
"전라남도","50~54세","2016 년","143411","76193","67218","113.4","141081","75133","65948","113.9",
"전라남도","50~54세","2017 년","143640","76408","67232","113.6","141303","75379","65924","114.3",
"전라남도","50~54세","2018 년","145188","77326","67862","113.9","142792","76234","66558","114.5",
"전라남도","50~54세","2019 년","147736","78917","68819","114.7","144898","77492","67406","115",
"전라남도","50~54세","2020 년","148786","79427","69359","114.5","146269","78291","67978","115.2",
"전라남도","50~54세","2021 년","150362","79895","70467","113.4","147818","78746","69072","114",
"전라남도","50~54세","2022 년","149908","79664","70244","113.4","147262","78426","68836","113.9",
"전라남도","50~54세","2023 년","147946","78522","69424","113.1","144777","76969","67808","113.5",
"전라남도","55~59세","2015 년","143786","73280","70506","103.9","142231","72521","69710","104",
"전라남도","55~59세","2016 년","151448","76939","74509","103.3","149821","76179","73642","103.4",
"전라남도","55~59세","2017 년","153229","78047","75182","103.8","151678","77354","74324","104.1",
"전라남도","55~59세","2018 년","155654","79688","75966","104.9","153942","78902","75040","105.1",
"전라남도","55~59세","2019 년","153304","79092","74212","106.6","151261","78106","73155","106.8",
"전라남도","55~59세","2020 년","150095","78187","71908","108.7","148181","77383","70798","109.3",
"전라남도","55~59세","2021 년","148699","78455","70244","111.7","146702","77621","69081","112.4",
"전라남도","55~59세","2022 년","149390","78853","70537","111.8","147339","78001","69338","112.5",
"전라남도","55~59세","2023 년","151382","80226","71156","112.7","149111","79207","69904","113.3",
"전라남도","60~64세","2015 년","110438","54732","55706","98.3","109565","54293","55272","98.2",
"전라남도","60~64세","2016 년","114484","56849","57635","98.6","113563","56400","57163","98.7",
"전라남도","60~64세","2017 년","119939","60069","59870","100.3","118933","59567","59366","100.3",
"전라남도","60~64세","2018 년","129201","65233","63968","102","128169","64749","63420","102.1",
"전라남도","60~64세","2019 년","137983","69758","68225","102.2","136825","69191","67634","102.3",
"전라남도","60~64세","2020 년","146835","74218","72617","102.2","145680","73683","71997","102.3",
"전라남도","60~64세","2021 년","155641","78618","77023","102.1","154503","78096","76407","102.2",
"전라남도","60~64세","2022 년","157952","80276","77676","103.3","156753","79715","77038","103.5",
"전라남도","60~64세","2023 년","161429","82574","78855","104.7","159996","81915","78081","104.9",
"전라남도","65~69세","2015 년","101161","48651","52510","92.7","100800","48459","52341","92.6",
"전라남도","65~69세","2016 년","103813","50344","53469","94.2","103368","50129","53239","94.2",
"전라남도","65~69세","2017 년","104820","51048","53772","94.9","104357","50823","53534","94.9",
"전라남도","65~69세","2018 년","103484","50480","53004","95.2","103036","50256","52780","95.2",
"전라남도","65~69세","2019 년","104778","51130","53648","95.3","104279","50880","53399","95.3",
"전라남도","65~69세","2020 년","110813","54259","56554","95.9","110278","54023","56255","96",
"전라남도","65~69세","2021 년","115614","56904","58710","96.9","115027","56633","58394","97",
"전라남도","65~69세","2022 년","121190","60234","60956","98.8","120525","59931","60594","98.9",
"전라남도","65~69세","2023 년","130795","65692","65103","100.9","129997","65323","64674","101",
"전라남도","70~74세","2015 년","97183","41608","55575","74.9","97034","41542","55492","74.9",
"전라남도","70~74세","2016 년","92203","40068","52135","76.9","92052","39997","52055","76.8",
"전라남도","70~74세","2017 년","89148","39617","49531","80","89002","39557","49445","80",
"전라남도","70~74세","2018 년","90013","40914","49099","83.3","89854","40851","49003","83.4",
"전라남도","70~74세","2019 년","93776","43483","50293","86.5","93579","43385","50194","86.4",
"전라남도","70~74세","2020 년","97589","45777","51812","88.4","97371","45672","51699","88.3",
"전라남도","70~74세","2021 년","100699","47591","53108","89.6","100463","47476","52987","89.6",
"전라남도","70~74세","2022 년","101577","48328","53249","90.8","101295","48203","53092","90.8",
"전라남도","70~74세","2023 년","100576","48046","52530","91.5","100256","47905","52351","91.5",
"전라남도","75~79세","2015 년","85207","32656","52551","62.1","85120","32609","52511","62.1",
"전라남도","75~79세","2016 년","87988","34230","53758","63.7","87885","34175","53710","63.6",
"전라남도","75~79세","2017 년","94255","37121","57134","65","94159","37081","57078","65",
"전라남도","75~79세","2018 년","93396","37152","56244","66.1","93301","37119","56182","66.1",
"전라남도","75~79세","2019 년","89749","36064","53685","67.2","89650","36025","53625","67.2",
"전라남도","75~79세","2020 년","87277","35302","51975","67.9","87181","35275","51906","68",
"전라남도","75~79세","2021 년","83680","34460","49220","70","83583","34432","49151","70.1",
"전라남도","75~79세","2022 년","81235","34417","46818","73.5","81112","34371","46741","73.5",
"전라남도","75~79세","2023 년","82538","35913","46625","77","82401","35863","46538","77.1",
"전라남도","80~84세","2015 년","53922","17039","36883","46.2","53889","17023","36866","46.2",
"전라남도","80~84세","2016 년","55794","18128","37666","48.1","55751","18106","37645","48.1",
"전라남도","80~84세","2017 년","59382","19650","39732","49.5","59336","19629","39707","49.4",
"전라남도","80~84세","2018 년","62349","21002","41347","50.8","62311","20985","41326","50.8",
"전라남도","80~84세","2019 년","65352","22437","42915","52.3","65287","22410","42877","52.3",
"전라남도","80~84세","2020 년","68307","23545","44762","52.6","68245","23524","44721","52.6",
"전라남도","80~84세","2021 년","71450","25021","46429","53.9","71381","24999","46382","53.9",
"전라남도","80~84세","2022 년","76579","27187","49392","55","76509","27169","49340","55.1",
"전라남도","80~84세","2023 년","76389","27490","48899","56.2","76305","27469","48836","56.2",
"전라남도","85~89세","2015 년","25324","6540","18784","34.8","25304","6532","18772","34.8",
"전라남도","85~89세","2016 년","26682","6829","19853","34.4","26663","6824","19839","34.4",
"전라남도","85~89세","2017 년","29278","7522","21756","34.6","29262","7518","21744","34.6",
"전라남도","85~89세","2018 년","30869","7962","22907","34.8","30850","7958","22892","34.8",
"전라남도","85~89세","2019 년","33277","8733","24544","35.6","33257","8726","24531","35.6",
"전라남도","85~89세","2020 년","34983","9467","25516","37.1","34968","9462","25506","37.1",
"전라남도","85~89세","2021 년","37653","10373","27280","38","37638","10368","27270","38",
"전라남도","85~89세","2022 년","39844","11136","28708","38.8","39818","11124","28694","38.8",
"전라남도","85~89세","2023 년","42162","11921","30241","39.4","42123","11902","30221","39.4",
"전라남도","90~94세","2015 년","7776","1702","6074","28","7767","1700","6067","28",
"전라남도","90~94세","2016 년","7784","1704","6080","28","7772","1699","6073","28",
"전라남도","90~94세","2017 년","8387","1797","6590","27.3","8384","1796","6588","27.3",
"전라남도","90~94세","2018 년","8805","1923","6882","27.9","8801","1922","6879","27.9",
"전라남도","90~94세","2019 년","10091","2244","7847","28.6","10080","2241","7839","28.6",
"전라남도","90~94세","2020 년","11952","2500","9452","26.4","11945","2498","9447","26.4",
"전라남도","90~94세","2021 년","13186","2714","10472","25.9","13179","2711","10468","25.9",
"전라남도","90~94세","2022 년","14220","2996","11224","26.7","14212","2994","11218","26.7",
"전라남도","90~94세","2023 년","14977","3118","11859","26.3","14968","3115","11853","26.3",
"전라남도","95~99세","2015 년","1568","238","1330","17.9","1562","235","1327","17.7",
"전라남도","95~99세","2016 년","1724","280","1444","19.4","1719","278","1441","19.3",
"전라남도","95~99세","2017 년","2023","337","1686","20","2022","337","1685","20",
"전라남도","95~99세","2018 년","2422","368","2054","17.9","2422","368","2054","17.9",
"전라남도","95~99세","2019 년","2424","390","2034","19.2","2423","389","2034","19.1",
"전라남도","95~99세","2020 년","2577","425","2152","19.7","2576","425","2151","19.8",
"전라남도","95~99세","2021 년","2618","470","2148","21.9","2618","470","2148","21.9",
"전라남도","95~99세","2022 년","2683","461","2222","20.7","2683","461","2222","20.7",
"전라남도","95~99세","2023 년","2917","497","2420","20.5","2916","496","2420","20.5",
"전라남도","100세이상","2015 년","210","23","187","12.3","209","22","187","11.8",
"전라남도","100세이상","2016 년","205","24","181","13.3","204","23","181","12.7",
"전라남도","100세이상","2017 년","220","22","198","11.1","220","22","198","11.1",
"전라남도","100세이상","2018 년","256","28","228","12.3","256","28","228","12.3",
"전라남도","100세이상","2019 년","268","34","234","14.5","267","34","233","14.6",
"전라남도","100세이상","2020 년","354","38","316","12","354","38","316","12",
"전라남도","100세이상","2021 년","391","40","351","11.4","391","40","351","11.4",
"전라남도","100세이상","2022 년","448","38","410","9.3","448","38","410","9.3",
"전라남도","100세이상","2023 년","511","57","454","12.6","511","57","454","12.6",
"전라남도","15세미만","2015 년","237267","122258","115009","106.3","236787","122021","114766","106.3",
"전라남도","15세미만","2016 년","231160","118878","112282","105.9","230630","118608","112022","105.9",
"전라남도","15세미만","2017 년","225914","116096","109818","105.7","225501","115889","109612","105.7",
"전라남도","15세미만","2018 년","219431","112641","106790","105.5","219012","112435","106577","105.5",
"전라남도","15세미만","2019 년","212598","108854","103744","104.9","212056","108578","103478","104.9",
"전라남도","15세미만","2020 년","208760","106884","101876","104.9","208246","106644","101602","105",
"전라남도","15세미만","2021 년","202541","103567","98974","104.6","201898","103267","98631","104.7",
"전라남도","15세미만","2022 년","193798","99140","94658","104.7","193085","98776","94309","104.7",
"전라남도","15세미만","2023 년","185660","94962","90698","104.7","184954","94591","90363","104.7",
"전라남도","15~64세","2015 년","1189426","630252","559174","112.7","1155961","609717","546244","111.6",
"전라남도","15~64세","2016 년","1188664","631015","557649","113.2","1153343","609260","544083","112",
"전라남도","15~64세","2017 년","1178892","625867","553025","113.2","1142864","603885","538979","112",
"전라남도","15~64세","2018 년","1179327","627684","551643","113.8","1137989","602227","535762","112.4",
"전라남도","15~64세","2019 년","1175230","628444","546786","114.9","1128887","599402","529485","113.2",
"전라남도","15~64세","2020 년","1166195","625084","541111","115.5","1122407","598171","524236","114.1",
"전라남도","15~64세","2021 년","1150292","615980","534312","115.3","1107787","590004","517783","113.9",
"전라남도","15~64세","2022 년","1139857","612237","527620","116","1092186","581543","510643","113.9",
"전라남도","15~64세","2023 년","1140143","616080","524063","117.6","1079744","575362","504382","114.1",
"전라남도","65세이상","2015 년","372351","148457","223894","66.3","371685","148122","223563","66.3",
"전라남도","65세이상","2016 년","376193","151607","224586","67.5","375414","151231","224183","67.5",
"전라남도","65세이상","2017 년","387513","157114","230399","68.2","386742","156763","229979","68.2",
"전라남도","65세이상","2018 년","391594","159829","231765","69","390831","159487","231344","68.9",
"전라남도","65세이상","2019 년","399715","164515","235200","69.9","398822","164090","234732","69.9",
"전라남도","65세이상","2020 년","413852","171313","242539","70.6","412918","170917","242001","70.6",
"전라남도","65세이상","2021 년","425291","177573","247718","71.7","424280","177129","247151","71.7",
"전라남도","65세이상","2022 년","437776","184797","252979","73","436602","184291","252311","73",
"전라남도","65세이상","2023 년","450865","192734","258131","74.7","449477","192130","257347","74.7",
"전라남도","85세이상","2015 년","34878","8503","26375","32.2","34842","8489","26353","32.2",
"전라남도","85세이상","2016 년","36395","8837","27558","32.1","36358","8824","27534","32",
"전라남도","85세이상","2017 년","39908","9678","30230","32","39888","9673","30215","32",
"전라남도","85세이상","2018 년","42352","10281","32071","32.1","42329","10276","32053","32.1",
"전라남도","85세이상","2019 년","46060","11401","34659","32.9","46027","11390","34637","32.9",
"전라남도","85세이상","2020 년","49866","12430","37436","33.2","49843","12423","37420","33.2",
"전라남도","85세이상","2021 년","53848","13597","40251","33.8","53826","13589","40237","33.8",
"전라남도","85세이상","2022 년","57195","14631","42564","34.4","57161","14617","42544","34.4",
"전라남도","85세이상","2023 년","60567","15593","44974","34.7","60518","15570","44948","34.6",
"전라남도","평균연령","2015 년","44.1","42.1","46.1","","44.2","42.2","46.2","",
"전라남도","평균연령","2016 년","44.4","42.4","46.4","","44.6","42.6","46.6","",
"전라남도","평균연령","2017 년","45","43","47","","45.2","43.2","47.2","",
"전라남도","평균연령","2018 년","45.4","43.5","47.4","","45.7","43.7","47.6","",
"전라남도","평균연령","2019 년","45.9","44","48","","46.2","44.3","48.2","",
"전라남도","평균연령","2020 년","46.5","44.5","48.5","","46.7","44.8","48.7","",
"전라남도","평균연령","2021 년","47.1","45.1","49.1","","47.4","45.4","49.3","",
"전라남도","평균연령","2022 년","47.7","45.7","49.7","","48","46.1","49.9","",
"전라남도","평균연령","2023 년","48.1","46.1","50.1","","48.5","46.7","50.4","",
"전라남도","중위연령","2015 년","45.6","43.7","47.8","","46","44.1","48","",
"전라남도","중위연령","2016 년","46.1","44.2","48.3","","46.5","44.7","48.5","",
"전라남도","중위연령","2017 년","46.9","45","49","","47.3","45.5","49.3","",
"전라남도","중위연령","2018 년","47.5","45.5","49.6","","48","46.2","50","",
"전라남도","중위연령","2019 년","48.1","46.2","50.3","","48.7","46.9","50.7","",
"전라남도","중위연령","2020 년","48.8","46.8","51","","49.4","47.5","51.4","",
"전라남도","중위연령","2021 년","49.7","47.7","51.8","","50.2","48.4","52.2","",
"전라남도","중위연령","2022 년","50.3","48.3","52.5","","51","49.2","52.9","",
"전라남도","중위연령","2023 년","50.8","48.7","53","","51.7","49.9","53.5","",
"경상북도","합계","2015 년","2680294","1351037","1329257","101.6","2622729","1314196","1308533","100.4",
"경상북도","합계","2016 년","2682169","1354997","1327172","102.1","2621463","1316296","1305167","100.9",
"경상북도","합계","2017 년","2677058","1353083","1323975","102.2","2613080","1312917","1300163","101",
"경상북도","합계","2018 년","2672902","1352869","1320033","102.5","2598831","1306914","1291917","101.2",
"경상북도","합계","2019 년","2668154","1352404","1315750","102.8","2586314","1301956","1284358","101.4",
"경상북도","합계","2020 년","2644757","1338823","1305934","102.5","2570210","1294138","1276072","101.4",
"경상북도","합계","2021 년","2635314","1332376","1302938","102.3","2562516","1289398","1273118","101.3",
"경상북도","합계","2022 년","2620373","1327631","1292742","102.7","2542225","1280814","1261411","101.5",
"경상북도","합계","2023 년","2589880","1317564","1272316","103.6","2498569","1261328","1237241","101.9",
"경상북도","0~4세","2015 년","112331","58027","54304","106.9","111791","57781","54010","107",
"경상북도","0~4세","2016 년","110450","57006","53444","106.7","109878","56724","53154","106.7",
"경상북도","0~4세","2017 년","103922","53543","50379","106.3","103305","53221","50084","106.3",
"경상북도","0~4세","2018 년","97377","50210","47167","106.5","96629","49841","46788","106.5",
"경상북도","0~4세","2019 년","90733","46610","44123","105.6","89627","46045","43582","105.7",
"경상북도","0~4세","2020 년","81604","41877","39727","105.4","80615","41382","39233","105.5",
"경상북도","0~4세","2021 년","73598","37778","35820","105.5","72555","37245","35310","105.5",
"경상북도","0~4세","2022 년","67048","34457","32591","105.7","66052","33935","32117","105.7",
"경상북도","0~4세","2023 년","60872","31266","29606","105.6","59787","30720","29067","105.7",
"경상북도","5~9세","2015 년","107840","56126","51714","108.5","107496","55953","51543","108.6",
"경상북도","5~9세","2016 년","109851","57121","52730","108.3","109442","56917","52525","108.4",
"경상북도","5~9세","2017 년","110300","57359","52941","108.3","109952","57195","52757","108.4",
"경상북도","5~9세","2018 년","109324","56731","52593","107.9","108857","56476","52381","107.8",
"경상북도","5~9세","2019 년","109118","56503","52615","107.4","108440","56155","52285","107.4",
"경상북도","5~9세","2020 년","108372","56119","52253","107.4","107761","55809","51952","107.4",
"경상북도","5~9세","2021 년","105766","54532","51234","106.4","104872","54090","50782","106.5",
"경상북도","5~9세","2022 년","99007","50814","48193","105.4","98026","50342","47684","105.6",
"경상북도","5~9세","2023 년","91832","47197","44635","105.7","90980","46784","44196","105.9",
"경상북도","10~14세","2015 년","116895","61628","55267","111.5","116738","61536","55202","111.5",
"경상북도","10~14세","2016 년","109567","57730","51837","111.4","109372","57630","51742","111.4",
"경상북도","10~14세","2017 년","107806","56519","51287","110.2","107592","56409","51183","110.2",
"경상북도","10~14세","2018 년","106938","55985","50953","109.9","106623","55825","50798","109.9",
"경상북도","10~14세","2019 년","105725","55240","50485","109.4","105282","55022","50260","109.5",
"경상북도","10~14세","2020 년","106715","55646","51069","109","106294","55430","50864","109",
"경상북도","10~14세","2021 년","108503","56406","52097","108.3","108010","56153","51857","108.3",
"경상북도","10~14세","2022 년","108634","56595","52039","108.8","108027","56291","51736","108.8",
"경상북도","10~14세","2023 년","107235","55717","51518","108.2","106557","55370","51187","108.2",
"경상북도","15~19세","2015 년","163791","88104","75687","116.4","162832","87646","75186","116.6",
"경상북도","15~19세","2016 년","158144","85047","73097","116.3","156872","84447","72425","116.6",
"경상북도","15~19세","2017 년","149154","80243","68911","116.4","147319","79396","67923","116.9",
"경상북도","15~19세","2018 년","141480","76179","65301","116.7","138941","75002","63939","117.3",
"경상북도","15~19세","2019 년","133650","71926","61724","116.5","131245","70774","60471","117",
"경상북도","15~19세","2020 년","120322","64905","55417","117.1","119205","64371","54834","117.4",
"경상북도","15~19세","2021 년","114129","61531","52598","117","113183","61081","52102","117.2",
"경상북도","15~19세","2022 년","112771","60497","52274","115.7","111233","59681","51552","115.8",
"경상북도","15~19세","2023 년","111648","59851","51797","115.5","109396","58571","50825","115.2",
"경상북도","20~24세","2015 년","171458","96526","74932","128.8","162946","91410","71536","127.8",
"경상북도","20~24세","2016 년","173588","98237","75351","130.4","164667","92959","71708","129.6",
"경상북도","20~24세","2017 년","171472","97456","74016","131.7","161828","91754","70074","130.9",
"경상북도","20~24세","2018 년","169986","96945","73041","132.7","157817","89677","68140","131.6",
"경상북도","20~24세","2019 년","164796","94430","70366","134.2","151471","86515","64956","133.2",
"경상북도","20~24세","2020 년","158436","90539","67897","133.3","147069","84050","63019","133.4",
"경상북도","20~24세","2021 년","151918","86399","65519","131.9","141802","80848","60954","132.6",
"경상북도","20~24세","2022 년","143505","82469","61036","135.1","133295","76606","56689","135.1",
"경상북도","20~24세","2023 년","135551","79331","56220","141.1","123412","71867","51545","139.4",
"경상북도","25~29세","2015 년","149623","84374","65249","129.3","136521","75703","60818","124.5",
"경상북도","25~29세","2016 년","148881","84582","64299","131.5","135395","75613","59782","126.5",
"경상북도","25~29세","2017 년","148590","85124","63466","134.1","134837","75915","58922","128.8",
"경상북도","25~29세","2018 년","149950","86382","63568","135.9","134703","76221","58482","130.3",
"경상북도","25~29세","2019 년","151259","87349","63910","136.7","135033","76591","58442","131.1",
"경상북도","25~29세","2020 년","149097","86470","62627","138.1","134586","77065","57521","134",
"경상북도","25~29세","2021 년","147747","85403","62344","137","134123","76722","57401","133.7",
"경상북도","25~29세","2022 년","145515","84708","60807","139.3","130916","75255","55661","135.2",
"경상북도","25~29세","2023 년","143234","84205","59029","142.7","126311","72992","53319","136.9",
"경상북도","30~34세","2015 년","174478","93893","80585","116.5","163734","86261","77473","111.3",
"경상북도","30~34세","2016 년","165123","89308","75815","117.8","153786","81323","72463","112.2",
"경상북도","30~34세","2017 년","154975","84419","70556","119.6","143193","76287","66906","114",
"경상북도","30~34세","2018 년","147935","81434","66501","122.5","134411","72448","61963","116.9",
"경상북도","30~34세","2019 년","143954","80198","63756","125.8","129210","70562","58648","120.3",
"경상북도","30~34세","2020 년","139326","77569","61757","125.6","125324","68672","56652","121.2",
"경상북도","30~34세","2021 년","137861","76992","60869","126.5","124380","68493","55887","122.6",
"경상북도","30~34세","2022 년","138625","78014","60611","128.7","124449","68785","55664","123.6",
"경상북도","30~34세","2023 년","141597","80624","60973","132.2","124782","69298","55484","124.9",
"경상북도","35~39세","2015 년","179540","95089","84451","112.6","172486","89938","82548","109",
"경상북도","35~39세","2016 년","182569","96826","85743","112.9","175114","91484","83630","109.4",
"경상북도","35~39세","2017 년","184749","97919","86830","112.8","176668","92327","84341","109.5",
"경상북도","35~39세","2018 년","185527","98199","87328","112.4","175787","91608","84179","108.8",
"경상북도","35~39세","2019 년","180096","95456","84640","112.8","169249","88277","80972","109",
"경상북도","35~39세","2020 년","168255","89176","79079","112.8","157660","82355","75305","109.4",
"경상북도","35~39세","2021 년","158775","84213","74562","112.9","148098","77414","70684","109.5",
"경상북도","35~39세","2022 년","148728","79554","69174","115","137252","72231","65021","111.1",
"경상북도","35~39세","2023 년","141534","76794","64740","118.6","128072","68104","59968","113.6",
"경상북도","40~44세","2015 년","203175","106270","96905","109.7","198195","102848","95347","107.9",
"경상북도","40~44세","2016 년","194693","101680","93013","109.3","189542","98168","91374","107.4",
"경상북도","40~44세","2017 년","188431","98030","90401","108.4","183164","94551","88613","106.7",
"경상북도","40~44세","2018 년","181216","94755","86461","109.6","175113","90863","84250","107.8",
"경상북도","40~44세","2019 년","176851","92763","84088","110.3","169845","88331","81514","108.4",
"경상북도","40~44세","2020 년","176603","92576","84027","110.2","169711","88300","81411","108.5",
"경상북도","40~44세","2021 년","179404","94013","85391","110.1","172360","89694","82666","108.5",
"경상북도","40~44세","2022 년","181623","95248","86375","110.3","173661","90401","83260","108.6",
"경상북도","40~44세","2023 년","181830","95443","86387","110.5","172467","89647","82820","108.2",
"경상북도","45~49세","2015 년","216380","112189","104191","107.7","212615","110054","102561","107.3",
"경상북도","45~49세","2016 년","217960","112990","104970","107.6","213883","110589","103294","107.1",
"경상북도","45~49세","2017 년","217952","113552","104400","108.8","213692","111069","102623","108.2",
"경상북도","45~49세","2018 년","213609","111118","102491","108.4","208895","108321","100574","107.7",
"경상북도","45~49세","2019 년","210989","109796","101193","108.5","205685","106617","99068","107.6",
"경상북도","45~49세","2020 년","204225","106083","98142","108.1","199406","103286","96120","107.5",
"경상북도","45~49세","2021 년","195476","101086","94390","107.1","190583","98284","92299","106.5",
"경상북도","45~49세","2022 년","189253","97592","91661","106.5","184106","94655","89451","105.8",
"경상북도","45~49세","2023 년","180923","93765","87158","107.6","175032","90447","84585","106.9",
"경상북도","50~54세","2015 년","224043","114892","109151","105.3","221097","113333","107764","105.2",
"경상북도","50~54세","2016 년","216891","112019","104872","106.8","213705","110323","103382","106.7",
"경상북도","50~54세","2017 년","213011","109670","103341","106.1","209678","107905","101773","106",
"경상북도","50~54세","2018 년","215833","110928","104905","105.7","212375","109119","103256","105.7",
"경상북도","50~54세","2019 년","220540","113525","107015","106.1","216588","111396","105192","105.9",
"경상북도","50~54세","2020 년","221464","114100","107364","106.3","217805","112242","105563","106.3",
"경상북도","50~54세","2021 년","223263","114704","108559","105.7","219496","112747","106749","105.6",
"경상북도","50~54세","2022 년","222620","114933","107687","106.7","218563","112845","105718","106.7",
"경상북도","50~54세","2023 년","216470","111925","104545","107.1","211830","109432","102398","106.9",
"경상북도","55~59세","2015 년","220294","110636","109658","100.9","218172","109567","108605","100.9",
"경상북도","55~59세","2016 년","230618","116305","114313","101.7","228464","115208","113256","101.7",
"경상북도","55~59세","2017 년","235410","118798","116612","101.9","233142","117651","115491","101.9",
"경상북도","55~59세","2018 년","238106","120370","117736","102.2","235724","119168","116556","102.2",
"경상북도","55~59세","2019 년","234911","119566","115345","103.7","232089","118092","113997","103.6",
"경상북도","55~59세","2020 년","228605","116897","111708","104.6","226035","115626","110409","104.7",
"경상북도","55~59세","2021 년","221816","113909","107907","105.6","219150","112611","106539","105.7",
"경상북도","55~59세","2022 년","219213","112209","107004","104.9","216394","110852","105542","105",
"경상북도","55~59세","2023 년","220062","112463","107599","104.5","216895","110910","105985","104.6",
"경상북도","60~64세","2015 년","171410","83454","87956","94.9","170153","82818","87335","94.8",
"경상북도","60~64세","2016 년","184790","90674","94116","96.3","183407","89950","93457","96.2",
"경상북도","60~64세","2017 년","192462","95484","96978","98.5","191033","94774","96259","98.5",
"경상북도","60~64세","2018 년","201152","100428","100724","99.7","199670","99666","100004","99.7",
"경상북도","60~64세","2019 년","211954","105889","106065","99.8","210368","105070","105298","99.8",
"경상북도","60~64세","2020 년","224079","112126","111953","100.2","222509","111396","111113","100.3",
"경상북도","60~64세","2021 년","235949","118407","117542","100.7","234336","117662","116674","100.8",
"경상북도","60~64세","2022 년","240510","121039","119471","101.3","238717","120195","118522","101.4",
"경상북도","60~64세","2023 년","241631","121997","119634","102","239583","121025","118558","102.1",
"경상북도","65~69세","2015 년","132256","64277","67979","94.6","131668","63989","67679","94.5",
"경상북도","65~69세","2016 년","141104","68592","72512","94.6","140488","68284","72204","94.6",
"경상북도","65~69세","2017 년","149198","72297","76901","94","148540","71980","76560","94",
"경상북도","65~69세","2018 년","153733","74438","79295","93.9","153057","74114","78943","93.9",
"경상북도","65~69세","2019 년","159098","77055","82043","93.9","158319","76669","81650","93.9",
"경상북도","65~69세","2020 년","171491","82920","88571","93.6","170719","82573","88146","93.7",
"경상북도","65~69세","2021 년","184723","89890","94833","94.8","183912","89521","94391","94.8",
"경상북도","65~69세","2022 년","192514","94865","97649","97.1","191578","94426","97152","97.2",
"경상북도","65~69세","2023 년","198451","98337","100114","98.2","197422","97866","99556","98.3",
"경상북도","70~74세","2015 년","121150","51874","69276","74.9","120919","51774","69145","74.9",
"경상북도","70~74세","2016 년","113652","49674","63978","77.6","113426","49567","63859","77.6",
"경상북도","70~74세","2017 년","110423","49421","61002","81","110168","49307","60861","81",
"경상북도","70~74세","2018 년","112399","51720","60679","85.2","112122","51598","60524","85.3",
"경상북도","70~74세","2019 년","119058","56269","62789","89.6","118733","56123","62610","89.6",
"경상북도","70~74세","2020 년","127172","60542","66630","90.9","126796","60387","66409","90.9",
"경상북도","70~74세","2021 년","135926","64628","71298","90.6","135515","64450","71065","90.7",
"경상북도","70~74세","2022 년","143976","68332","75644","90.3","143500","68130","75370","90.4",
"경상북도","70~74세","2023 년","146502","69406","77096","90","145985","69193","76792","90.1",
"경상북도","75~79세","2015 년","106253","41089","65164","63.1","106111","41034","65077","63.1",
"경상북도","75~79세","2016 년","107542","41900","65642","63.8","107396","41838","65558","63.8",
"경상북도","75~79세","2017 년","114546","45191","69355","65.2","114426","45148","69278","65.2",
"경상북도","75~79세","2018 년","116467","46470","69997","66.4","116341","46424","69917","66.4",
"경상북도","75~79세","2019 년","113723","45750","67973","67.3","113573","45688","67885","67.3",
"경상북도","75~79세","2020 년","109622","44544","65078","68.4","109477","44492","64985","68.5",
"경상북도","75~79세","2021 년","103376","42970","60406","71.1","103219","42909","60310","71.1",
"경상북도","75~79세","2022 년","100542","43065","57477","74.9","100346","42991","57355","75",
"경상북도","75~79세","2023 년","101235","44741","56494","79.2","100983","44651","56332","79.3",
"경상북도","80~84세","2015 년","67358","22237","45121","49.3","67299","22215","45084","49.3",
"경상북도","80~84세","2016 년","72154","24318","47836","50.8","72093","24303","47790","50.9",
"경상북도","80~84세","2017 년","75849","25851","49998","51.7","75779","25832","49947","51.7",
"경상북도","80~84세","2018 년","79482","27324","52158","52.4","79406","27298","52108","52.4",
"경상북도","80~84세","2019 년","84217","29251","54966","53.2","84131","29221","54910","53.2",
"경상북도","80~84세","2020 년","86044","30185","55859","54","85955","30160","55795","54.1",
"경상북도","80~84세","2021 년","88039","31206","56833","54.9","87940","31177","56763","54.9",
"경상북도","80~84세","2022 년","94038","33845","60193","56.2","93933","33813","60120","56.2",
"경상북도","80~84세","2023 년","94305","34370","59935","57.3","94192","34336","59856","57.4",
"경상북도","85~89세","2015 년","29890","7798","22092","35.3","29851","7786","22065","35.3",
"경상북도","85~89세","2016 년","31846","8353","23493","35.6","31810","8339","23471","35.5",
"경상북도","85~89세","2017 년","34732","9291","25441","36.5","34700","9280","25420","36.5",
"경상북도","85~89세","2018 년","37215","10182","27033","37.7","37196","10174","27022","37.7",
"경상북도","85~89세","2019 년","40928","11501","29427","39.1","40901","11490","29411","39.1",
"경상북도","85~89세","2020 년","45238","12950","32288","40.1","45210","12945","32265","40.1",
"경상북도","85~89세","2021 년","49401","14366","35035","41","49355","14356","34999","41",
"경상북도","85~89세","2022 년","51401","15073","36328","41.5","51343","15061","36282","41.5",
"경상북도","85~89세","2023 년","52873","15550","37323","41.7","52806","15535","37271","41.7",
"경상북도","90~94세","2015 년","9933","2188","7745","28.3","9919","2186","7733","28.3",
"경상북도","90~94세","2016 년","10346","2241","8105","27.6","10334","2240","8094","27.7",
"경상북도","90~94세","2017 년","11293","2468","8825","28","11286","2468","8818","28",
"경상북도","90~94세","2018 년","12151","2591","9560","27.1","12143","2591","9552","27.1",
"경상북도","90~94세","2019 년","13401","2814","10587","26.6","13379","2808","10571","26.6",
"경상북도","90~94세","2020 년","14643","3046","11597","26.3","14631","3044","11587","26.3",
"경상북도","90~94세","2021 년","15911","3396","12515","27.1","15900","3395","12505","27.1",
"경상북도","90~94세","2022 년","17049","3730","13319","28","17038","3728","13310","28",
"경상북도","90~94세","2023 년","17953","3926","14027","28","17941","3925","14016","28",
"경상북도","95~99세","2015 년","1970","337","1633","20.6","1961","335","1626","20.6",
"경상북도","95~99세","2016 년","2158","363","1795","20.2","2148","359","1789","20.1",
"경상북도","95~99세","2017 년","2508","405","2103","19.3","2503","405","2098","19.3",
"경상북도","95~99세","2018 년","2712","439","2273","19.3","2711","439","2272","19.3",
"경상북도","95~99세","2019 년","2812","472","2340","20.2","2805","469","2336","20.1",
"경상북도","95~99세","2020 년","3051","510","2541","20.1","3049","510","2539","20.1",
"경상북도","95~99세","2021 년","3265","505","2760","18.3","3259","504","2755","18.3",
"경상북도","95~99세","2022 년","3323","542","2781","19.5","3318","541","2777","19.5",
"경상북도","95~99세","2023 년","3683","608","3075","19.8","3678","607","3071","19.8",
"경상북도","100세이상","2015 년","226","29","197","14.7","225","29","196","14.8",
"경상북도","100세이상","2016 년","242","31","211","14.7","241","31","210","14.8",
"경상북도","100세이상","2017 년","275","43","232","18.5","275","43","232","18.5",
"경상북도","100세이상","2018 년","310","41","269","15.2","310","41","269","15.2",
"경상북도","100세이상","2019 년","341","41","300","13.7","341","41","300","13.7",
"경상북도","100세이상","2020 년","393","43","350","12.3","393","43","350","12.3",
"경상북도","100세이상","2021 년","468","42","426","9.9","468","42","426","9.9",
"경상북도","100세이상","2022 년","478","50","428","11.7","478","50","428","11.7",
"경상북도","100세이상","2023 년","459","48","411","11.7","458","48","410","11.7",
"경상북도","15세미만","2015 년","337066","175781","161285","109","336025","175270","160755","109",
"경상북도","15세미만","2016 년","329868","171857","158011","108.8","328692","171271","157421","108.8",
"경상북도","15세미만","2017 년","322028","167421","154607","108.3","320849","166825","154024","108.3",
"경상북도","15세미만","2018 년","313639","162926","150713","108.1","312109","162142","149967","108.1",
"경상북도","15세미만","2019 년","305576","158353","147223","107.6","303349","157222","146127","107.6",
"경상북도","15세미만","2020 년","296691","153642","143049","107.4","294670","152621","142049","107.4",
"경상북도","15세미만","2021 년","287867","148716","139151","106.9","285437","147488","137949","106.9",
"경상북도","15세미만","2022 년","274689","141866","132823","106.8","272105","140568","131537","106.9",
"경상북도","15세미만","2023 년","259939","134180","125759","106.7","257324","132874","124450","106.8",
"경상북도","15~64세","2015 년","1874192","985427","888765","110.9","1818751","949578","869173","109.3",
"경상북도","15~64세","2016 년","1873257","987668","885589","111.5","1814835","950064","864771","109.9",
"경상북도","15~64세","2017 년","1856206","980695","875511","112","1794554","941629","852925","110.4",
"경상북도","15~64세","2018 년","1844794","976738","868056","112.5","1773436","932093","841343","110.8",
"경상북도","15~64세","2019 년","1829000","970898","858102","113.1","1750783","922225","828558","111.3",
"경상북도","15~64세","2020 년","1790412","950441","839971","113.2","1719310","907363","811947","111.8",
"경상북도","15~64세","2021 년","1766338","936657","829681","112.9","1697511","895556","801955","111.7",
"경상북도","15~64세","2022 년","1742363","926263","816100","113.5","1668586","881506","787080","112",
"경상북도","15~64세","2023 년","1714480","916398","798082","114.8","1627780","862293","765487","112.6",
"경상북도","65세이상","2015 년","469036","189829","279207","68","467953","189348","278605","68",
"경상북도","65세이상","2016 년","479044","195472","283572","68.9","477936","194961","282975","68.9",
"경상북도","65세이상","2017 년","498824","204967","293857","69.8","497677","204463","293214","69.7",
"경상북도","65세이상","2018 년","514469","213205","301264","70.8","513286","212679","300607","70.7",
"경상북도","65세이상","2019 년","533578","223153","310425","71.9","532182","222509","309673","71.9",
"경상북도","65세이상","2020 년","557654","234740","322914","72.7","556230","234154","322076","72.7",
"경상북도","65세이상","2021 년","581109","247003","334106","73.9","579568","246354","333214","73.9",
"경상북도","65세이상","2022 년","603321","259502","343819","75.5","601534","258740","342794","75.5",
"경상북도","65세이상","2023 년","615461","266986","348475","76.6","613465","266161","347304","76.6",
"경상북도","85세이상","2015 년","42019","10352","31667","32.7","41956","10336","31620","32.7",
"경상북도","85세이상","2016 년","44592","10988","33604","32.7","44533","10969","33564","32.7",
"경상북도","85세이상","2017 년","48808","12207","36601","33.4","48764","12196","36568","33.4",
"경상북도","85세이상","2018 년","52388","13253","39135","33.9","52360","13245","39115","33.9",
"경상북도","85세이상","2019 년","57482","14828","42654","34.8","57426","14808","42618","34.7",
"경상북도","85세이상","2020 년","63325","16549","46776","35.4","63283","16542","46741","35.4",
"경상북도","85세이상","2021 년","69045","18309","50736","36.1","68982","18297","50685","36.1",
"경상북도","85세이상","2022 년","72251","19395","52856","36.7","72177","19380","52797","36.7",
"경상북도","85세이상","2023 년","74968","20132","54836","36.7","74883","20115","54768","36.7",
"경상북도","평균연령","2015 년","42.9","41.1","44.8","","43.1","41.2","45","",
"경상북도","평균연령","2016 년","43.4","41.5","45.3","","43.6","41.7","45.4","",
"경상북도","평균연령","2017 년","43.9","42","45.8","","44.1","42.3","46","",
"경상북도","평균연령","2018 년","44.4","42.6","46.4","","44.7","42.9","46.6","",
"경상북도","평균연령","2019 년","45","43.2","46.9","","45.4","43.5","47.2","",
"경상북도","평균연령","2020 년","45.7","43.9","47.7","","46","44.2","47.9","",
"경상북도","평균연령","2021 년","46.3","44.5","48.2","","46.7","44.8","48.5","",
"경상북도","평균연령","2022 년","46.9","45.1","48.8","","47.3","45.5","49.1","",
"경상북도","평균연령","2023 년","47.4","45.5","49.3","","47.9","46","49.7","",
"경상북도","중위연령","2015 년","44.1","42.1","46.2","","44.5","42.6","46.5","",
"경상북도","중위연령","2016 년","44.7","42.7","46.9","","45.2","43.2","47.2","",
"경상북도","중위연령","2017 년","45.5","43.4","47.6","","46","44","48","",
"경상북도","중위연령","2018 년","46.1","44","48.3","","46.8","44.8","48.8","",
"경상북도","중위연령","2019 년","46.9","44.8","49.1","","47.6","45.6","49.6","",
"경상북도","중위연령","2020 년","47.9","45.8","50","","48.5","46.5","50.5","",
"경상북도","중위연령","2021 년","48.7","46.6","50.8","","49.3","47.3","51.3","",
"경상북도","중위연령","2022 년","49.4","47.3","51.6","","50.1","48.2","52.1","",
"경상북도","중위연령","2023 년","50","47.7","52.2","","50.8","48.9","52.8","",
"경상남도","합계","2015 년","3334524","1698737","1635787","103.8","3244163","1634407","1609756","101.5",
"경상남도","합계","2016 년","3339633","1701849","1637784","103.9","3247448","1636954","1610494","101.6",
"경상남도","합계","2017 년","3345293","1702150","1643143","103.6","3254221","1639600","1614621","101.5",
"경상남도","합계","2018 년","3350350","1703904","1646446","103.5","3252856","1637986","1614870","101.4",
"경상남도","합계","2019 년","3347209","1703892","1643317","103.7","3241301","1632680","1608621","101.5",
"경상남도","합계","2020 년","3333056","1692212","1640844","103.1","3236387","1629100","1607287","101.4",
"경상남도","합계","2021 년","3305931","1676753","1629178","102.9","3214095","1617823","1596272","101.4",
"경상남도","합계","2022 년","3280829","1664969","1615860","103","3184526","1602556","1581970","101.3",
"경상남도","합계","2023 년","3271148","1665898","1605250","103.8","3153913","1586694","1567219","101.2",
"경상남도","0~4세","2015 년","156525","80704","75821","106.4","155488","80170","75318","106.4",
"경상남도","0~4세","2016 년","152545","78417","74128","105.8","151512","77903","73609","105.8",
"경상남도","0~4세","2017 년","144635","74315","70320","105.7","143688","73837","69851","105.7",
"경상남도","0~4세","2018 년","136158","69913","66245","105.5","135000","69339","65661","105.6",
"경상남도","0~4세","2019 년","125576","64363","61213","105.1","124060","63584","60476","105.1",
"경상남도","0~4세","2020 년","112320","57677","54643","105.6","110979","56993","53986","105.6",
"경상남도","0~4세","2021 년","99686","51300","48386","106","98354","50643","47711","106.1",
"경상남도","0~4세","2022 년","88868","45568","43300","105.2","87609","44926","42683","105.3",
"경상남도","0~4세","2023 년","80374","41273","39101","105.6","79096","40599","38497","105.5",
"경상남도","5~9세","2015 년","158209","81869","76340","107.2","157517","81518","75999","107.3",
"경상남도","5~9세","2016 년","161229","83329","77900","107","160456","82946","77510","107",
"경상남도","5~9세","2017 년","162159","83639","78520","106.5","161552","83333","78219","106.5",
"경상남도","5~9세","2018 년","160413","82823","77590","106.7","159682","82457","77225","106.8",
"경상남도","5~9세","2019 년","160353","82720","77633","106.6","159267","82176","77091","106.6",
"경상남도","5~9세","2020 년","158251","81482","76769","106.1","157227","80961","76266","106.2",
"경상남도","5~9세","2021 년","153280","78831","74449","105.9","151941","78153","73788","105.9",
"경상남도","5~9세","2022 년","143430","73834","69596","106.1","142036","73129","68907","106.1",
"경상남도","5~9세","2023 년","133381","68735","64646","106.3","132204","68158","64046","106.4",
"경상남도","10~14세","2015 년","165027","87071","77956","111.7","164633","86872","77761","111.7",
"경상남도","10~14세","2016 년","156087","81997","74090","110.7","155633","81779","73854","110.7",
"경상남도","10~14세","2017 년","155405","81344","74061","109.8","155034","81163","73871","109.9",
"경상남도","10~14세","2018 년","155817","81009","74808","108.3","155327","80758","74569","108.3",
"경상남도","10~14세","2019 년","154990","80325","74665","107.6","154340","79997","74343","107.6",
"경상남도","10~14세","2020 년","157784","81681","76103","107.3","157121","81353","75768","107.4",
"경상남도","10~14세","2021 년","161109","83169","77940","106.7","160364","82784","77580","106.7",
"경상남도","10~14세","2022 년","161286","83138","78148","106.4","160400","82701","77699","106.4",
"경상남도","10~14세","2023 년","158764","81929","76835","106.6","157795","81436","76359","106.6",
"경상남도","15~19세","2015 년","208104","111484","96620","115.4","207411","111174","96237","115.5",
"경상남도","15~19세","2016 년","199413","106634","92779","114.9","198603","106258","92345","115.1",
"경상남도","15~19세","2017 년","187833","100527","87306","115.1","186796","99981","86815","115.2",
"경상남도","15~19세","2018 년","177600","95305","82295","115.8","176316","94602","81714","115.8",
"경상남도","15~19세","2019 년","167002","89778","77224","116.3","165435","88961","76474","116.3",
"경상남도","15~19세","2020 년","155935","83440","72495","115.1","154959","82920","72039","115.1",
"경상남도","15~19세","2021 년","148364","78984","69380","113.8","147416","78538","68878","114",
"경상남도","15~19세","2022 년","146999","77820","69179","112.5","145748","77149","68599","112.5",
"경상남도","15~19세","2023 년","146747","77328","69419","111.4","144922","76246","68676","111",
"경상남도","20~24세","2015 년","204793","118127","86666","136.3","194204","110927","83277","133.2",
"경상남도","20~24세","2016 년","205082","118416","86666","136.6","195198","111892","83306","134.3",
"경상남도","20~24세","2017 년","200573","115751","84822","136.5","191438","109998","81440","135.1",
"경상남도","20~24세","2018 년","198855","114850","84005","136.7","188367","108191","80176","134.9",
"경상남도","20~24세","2019 년","192416","111647","80769","138.2","180758","104078","76680","135.7",
"경상남도","20~24세","2020 년","188811","108384","80427","134.8","179537","102593","76944","133.3",
"경상남도","20~24세","2021 년","176035","101822","74213","137.2","168540","97412","71128","137",
"경상남도","20~24세","2022 년","163323","95048","68275","139.2","155461","90265","65196","138.5",
"경상남도","20~24세","2023 년","152673","90017","62656","143.7","141817","82642","59175","139.7",
"경상남도","25~29세","2015 년","190156","107800","82356","130.9","168655","91413","77242","118.3",
"경상남도","25~29세","2016 년","190435","108016","82419","131.1","169649","92300","77349","119.3",
"경상남도","25~29세","2017 년","190998","107683","83315","129.2","171338","93245","78093","119.4",
"경상남도","25~29세","2018 년","194467","109699","84768","129.4","174382","95198","79184","120.2",
"경상남도","25~29세","2019 년","196129","111070","85059","130.6","175434","96271","79163","121.6",
"경상남도","25~29세","2020 년","194483","110005","84478","130.2","176865","97906","78959","124",
"경상남도","25~29세","2021 년","190608","108207","82401","131.3","174945","97552","77393","126",
"경상남도","25~29세","2022 년","185570","106007","79563","133.2","168933","94363","74570","126.5",
"경상남도","25~29세","2023 년","182669","105449","77220","136.6","162056","90450","71606","126.3",
"경상남도","30~34세","2015 년","239910","130761","109149","119.8","221650","116148","105502","110.1",
"경상남도","30~34세","2016 년","226227","123978","102249","121.3","207206","109005","98201","111",
"경상남도","30~34세","2017 년","211996","116345","95651","121.6","192691","101537","91154","111.4",
"경상남도","30~34세","2018 년","201095","110616","90479","122.3","180466","95268","85198","111.8",
"경상남도","30~34세","2019 년","194809","107879","86930","124.1","173220","91951","81269","113.1",
"경상남도","30~34세","2020 년","187590","103442","84148","122.9","167446","89070","78376","113.6",
"경상남도","30~34세","2021 년","183462","100773","82689","121.9","165058","87935","77123","114",
"경상남도","30~34세","2022 년","183847","101988","81859","124.6","164963","88624","76339","116.1",
"경상남도","30~34세","2023 년","189346","106895","82451","129.6","166018","89622","76396","117.3",
"경상남도","35~39세","2015 년","254746","134816","119930","112.4","243328","125881","117447","107.2",
"경상남도","35~39세","2016 년","260054","138078","121976","113.2","247969","128697","119272","107.9",
"경상남도","35~39세","2017 년","264841","140405","124436","112.8","252281","130903","121378","107.8",
"경상남도","35~39세","2018 년","265736","140598","125138","112.4","251613","130126","121487","107.1",
"경상남도","35~39세","2019 년","257405","136227","121178","112.4","241872","124947","116925","106.9",
"경상남도","35~39세","2020 년","239226","126641","112585","112.5","223838","115645","108193","106.9",
"경상남도","35~39세","2021 년","222205","117875","104330","113","206836","107022","99814","107.2",
"경상남도","35~39세","2022 년","205804","109537","96267","113.8","189669","98191","91478","107.3",
"경상남도","35~39세","2023 년","195600","105571","90029","117.3","175741","91253","84488","108",
"경상남도","40~44세","2015 년","283354","147342","136012","108.3","275179","141427","133752","105.7",
"경상남도","40~44세","2016 년","270635","141078","129557","108.9","262255","135002","127253","106.1",
"경상남도","40~44세","2017 년","263101","136577","126524","107.9","255008","130845","124163","105.4",
"경상남도","40~44세","2018 년","254207","132335","121872","108.6","245233","126115","119118","105.9",
"경상남도","40~44세","2019 년","250743","130884","119859","109.2","240852","124106","116746","106.3",
"경상남도","40~44세","2020 년","253786","132265","121521","108.8","244335","125853","118482","106.2",
"경상남도","40~44세","2021 년","258302","134561","123741","108.7","248706","128113","120593","106.2",
"경상남도","40~44세","2022 년","261142","135915","125227","108.5","250781","129010","121771","105.9",
"경상남도","40~44세","2023 년","260891","136194","124697","109.2","248459","127689","120770","105.7",
"경상남도","45~49세","2015 년","291991","149791","142200","105.3","285702","145939","139763","104.4",
"경상남도","45~49세","2016 년","297162","151815","145347","104.5","290360","147563","142797","103.3",
"경상남도","45~49세","2017 년","298226","153413","144813","105.9","291407","149204","142203","104.9",
"경상남도","45~49세","2018 년","295793","152356","143437","106.2","288911","148116","140795","105.2",
"경상남도","45~49세","2019 년","291703","150515","141188","106.6","284105","145713","138392","105.3",
"경상남도","45~49세","2020 년","282901","145662","137239","106.1","275952","141382","134570","105.1",
"경상남도","45~49세","2021 년","269224","138650","130574","106.2","262427","134392","128035","105",
"경상남도","45~49세","2022 년","261180","134141","127039","105.6","254450","129942","124508","104.4",
"경상남도","45~49세","2023 년","252376","130158","122218","106.5","244484","125232","119252","105",
"경상남도","50~54세","2015 년","279912","143426","136486","105.1","274964","140704","134260","104.8",
"경상남도","50~54세","2016 년","272906","140932","131974","106.8","267481","137913","129568","106.4",
"경상남도","50~54세","2017 년","271244","139171","132073","105.4","265874","136245","129629","105.1",
"경상남도","50~54세","2018 년","277459","141065","136394","103.4","272262","138230","134032","103.1",
"경상남도","50~54세","2019 년","289172","147229","141943","103.7","283369","143902","139467","103.2",
"경상남도","50~54세","2020 년","293790","149729","144061","103.9","288390","146742","141648","103.6",
"경상남도","50~54세","2021 년","298716","151376","147340","102.7","293215","148309","144906","102.3",
"경상남도","50~54세","2022 년","298337","152182","146155","104.1","292632","148914","143718","103.6",
"경상남도","50~54세","2023 년","295532","151293","144239","104.9","289086","147550","141536","104.2",
"경상남도","55~59세","2015 년","260678","132062","128616","102.7","257563","130400","127163","102.5",
"경상남도","55~59세","2016 년","276978","139961","137017","102.1","273780","138228","135552","102",
"경상남도","55~59세","2017 년","286687","144897","141790","102.2","283267","143085","140182","102.1",
"경상남도","55~59세","2018 년","290088","146891","143197","102.6","286442","144983","141459","102.5",
"경상남도","55~59세","2019 년","286323","145052","141271","102.7","282191","142861","139330","102.5",
"경상남도","55~59세","2020 년","280683","142317","138366","102.9","276624","140255","136369","102.8",
"경상남도","55~59세","2021 년","272262","139213","133049","104.6","268112","137050","131062","104.6",
"경상남도","55~59세","2022 년","270732","137739","132993","103.6","266560","135614","130946","103.6",
"경상남도","55~59세","2023 년","277438","140071","137367","102","272850","137650","135200","101.8",
"경상남도","60~64세","2015 년","187560","92785","94775","97.9","185637","91759","93878","97.7",
"경상남도","60~64세","2016 년","203934","101137","102797","98.4","201854","100055","101799","98.3",
"경상남도","60~64세","2017 년","217121","108098","109023","99.2","214953","106966","107987","99.1",
"경상남도","60~64세","2018 년","233714","116896","116818","100.1","231590","115812","115778","100",
"경상남도","60~64세","2019 년","248003","124073","123930","100.1","245727","122877","122850","100",
"경상남도","60~64세","2020 년","262593","131550","131043","100.4","260218","130350","129868","100.4",
"경상남도","60~64세","2021 년","278977","139446","139531","99.9","276652","138297","138355","100",
"경상남도","60~64세","2022 년","286351","143352","142999","100.2","283726","142056","141670","100.3",
"경상남도","60~64세","2023 년","290752","146146","144606","101.1","287637","144576","143061","101.1",
"경상남도","65~69세","2015 년","138891","66970","71921","93.1","138151","66588","71563","93",
"경상남도","65~69세","2016 년","147140","70997","76143","93.2","146316","70603","75713","93.3",
"경상남도","65~69세","2017 년","156386","75945","80441","94.4","155452","75479","79973","94.4",
"경상남도","65~69세","2018 년","160457","77932","82525","94.4","159444","77432","82012","94.4",
"경상남도","65~69세","2019 년","169077","82596","86481","95.5","167991","82075","85916","95.5",
"경상남도","65~69세","2020 년","186541","90816","95725","94.9","185423","90311","95112","95",
"경상남도","65~69세","2021 년","202349","98842","103507","95.5","201098","98273","102825","95.6",
"경상남도","65~69세","2022 년","214518","105298","109220","96.4","213162","104667","108495","96.5",
"경상남도","65~69세","2023 년","230305","113668","116637","97.5","228756","112924","115832","97.5",
"경상남도","70~74세","2015 년","116928","49890","67038","74.4","116664","49767","66897","74.4",
"경상남도","70~74세","2016 년","112815","49123","63692","77.1","112522","48992","63530","77.1",
"경상남도","70~74세","2017 년","113432","50648","62784","80.7","113114","50508","62606","80.7",
"경상남도","70~74세","2018 년","119054","54421","64633","84.2","118700","54275","64425","84.2",
"경상남도","70~74세","2019 년","125887","58619","67268","87.1","125455","58418","67037","87.1",
"경상남도","70~74세","2020 년","134159","63035","71124","88.6","133673","62823","70850","88.7",
"경상남도","70~74세","2021 년","142025","66728","75297","88.6","141511","66508","75003","88.7",
"경상남도","70~74세","2022 년","150721","71274","79447","89.7","150144","71029","79115","89.8",
"경상남도","70~74세","2023 년","154537","73226","81311","90.1","153814","72921","80893","90.1",
"경상남도","75~79세","2015 년","97707","36400","61307","59.4","97513","36323","61190","59.4",
"경상남도","75~79세","2016 년","100841","38147","62694","60.8","100652","38076","62576","60.8",
"경상남도","75~79세","2017 년","106396","40862","65534","62.4","106206","40786","65420","62.3",
"경상남도","75~79세","2018 년","108845","42401","66444","63.8","108675","42340","66335","63.8",
"경상남도","75~79세","2019 년","108310","43045","65265","66","108114","42969","65145","66",
"경상남도","75~79세","2020 년","106834","43212","63622","67.9","106619","43141","63478","68",
"경상남도","75~79세","2021 년","103393","42917","60476","71","103182","42842","60340","71",
"경상남도","75~79세","2022 년","104097","44564","59533","74.9","103832","44476","59356","74.9",
"경상남도","75~79세","2023 년","109448","48091","61357","78.4","109106","47966","61140","78.5",
"경상남도","80~84세","2015 년","62089","18841","43248","43.6","62010","18814","43196","43.6",
"경상남도","80~84세","2016 년","65799","20646","45153","45.7","65702","20611","45091","45.7",
"경상남도","80~84세","2017 년","69562","22358","47204","47.4","69472","22326","47146","47.4",
"경상남도","80~84세","2018 년","72467","23698","48769","48.6","72364","23660","48704","48.6",
"경상남도","80~84세","2019 년","76533","25451","51082","49.8","76411","25402","51009","49.8",
"경상남도","80~84세","2020 년","79630","26954","52676","51.2","79504","26904","52600","51.1",
"경상남도","80~84세","2021 년","83014","28587","54427","52.5","82882","28546","54336","52.5",
"경상남도","80~84세","2022 년","87865","30814","57051","54","87726","30770","56956","54",
"경상남도","80~84세","2023 년","90136","32039","58097","55.1","89978","31988","57990","55.2",
"경상남도","85~89세","2015 년","27780","6631","21149","31.4","27750","6622","21128","31.3",
"경상남도","85~89세","2016 년","29738","7126","22612","31.5","29708","7118","22590","31.5",
"경상남도","85~89세","2017 년","32897","7910","24987","31.7","32869","7904","24965","31.7",
"경상남도","85~89세","2018 년","35144","8623","26521","32.5","35117","8617","26500","32.5",
"경상남도","85~89세","2019 년","38103","9579","28524","33.6","38059","9569","28490","33.6",
"경상남도","85~89세","2020 년","41492","10873","30619","35.5","41452","10860","30592","35.5",
"경상남도","85~89세","2021 년","45002","12118","32884","36.9","44953","12104","32849","36.8",
"경상남도","85~89세","2022 년","47391","13113","34278","38.3","47343","13097","34246","38.2",
"경상남도","85~89세","2023 년","49423","13869","35554","39","49362","13851","35511","39",
"경상남도","90~94세","2015 년","8628","1694","6934","24.4","8614","1690","6924","24.4",
"경상남도","90~94세","2016 년","8893","1740","7153","24.3","8880","1735","7145","24.3",
"경상남도","90~94세","2017 년","9817","1932","7885","24.5","9801","1928","7873","24.5",
"경상남도","90~94세","2018 년","10669","2101","8568","24.5","10655","2097","8558","24.5",
"경상남도","90~94세","2019 년","12181","2431","9750","24.9","12156","2420","9736","24.9",
"경상남도","90~94세","2020 년","13406","2619","10787","24.3","13390","2613","10777","24.2",
"경상남도","90~94세","2021 년","14794","2879","11915","24.2","14784","2877","11907","24.2",
"경상남도","90~94세","2022 년","16016","3127","12889","24.3","16005","3124","12881","24.3",
"경상남도","90~94세","2023 년","17104","3420","13684","25","17086","3417","13669","25",
"경상남도","95~99세","2015 년","1374","257","1117","23","1369","255","1114","22.9",
"경상남도","95~99세","2016 년","1542","264","1278","20.7","1536","261","1275","20.5",
"경상남도","95~99세","2017 년","1784","307","1477","20.8","1781","305","1476","20.7",
"경상남도","95~99세","2018 년","2094","342","1752","19.5","2092","340","1752","19.4",
"경상남도","95~99세","2019 년","2272","377","1895","19.9","2264","372","1892","19.7",
"경상남도","95~99세","2020 년","2551","383","2168","17.7","2546","381","2165","17.6",
"경상남도","95~99세","2021 년","2780","423","2357","17.9","2776","422","2354","17.9",
"경상남도","95~99세","2022 년","2999","461","2538","18.2","2994","461","2533","18.2",
"경상남도","95~99세","2023 년","3261","472","2789","16.9","3257","472","2785","16.9",
"경상남도","100세이상","2015 년","162","16","146","11","161","16","145","11",
"경상남도","100세이상","2016 년","178","18","160","11.3","176","17","159","10.7",
"경상남도","100세이상","2017 년","200","23","177","13","199","22","177","12.4",
"경상남도","100세이상","2018 년","218","30","188","16","218","30","188","16",
"경상남도","100세이상","2019 년","222","32","190","16.8","221","31","190","16.3",
"경상남도","100세이상","2020 년","290","45","245","18.4","289","44","245","18",
"경상남도","100세이상","2021 년","344","52","292","17.8","343","51","292","17.5",
"경상남도","100세이상","2022 년","353","49","304","16.1","352","48","304","15.8",
"경상남도","100세이상","2023 년","391","54","337","16","389","52","337","15.4",
"경상남도","15세미만","2015 년","479761","249644","230117","108.5","477638","248560","229078","108.5",
"경상남도","15세미만","2016 년","469861","243743","226118","107.8","467601","242628","224973","107.8",
"경상남도","15세미만","2017 년","462199","239298","222901","107.4","460274","238333","221941","107.4",
"경상남도","15세미만","2018 년","452388","233745","218643","106.9","450009","232554","217455","106.9",
"경상남도","15세미만","2019 년","440919","227408","213511","106.5","437667","225757","211910","106.5",
"경상남도","15세미만","2020 년","428355","220840","207515","106.4","425327","219307","206020","106.4",
"경상남도","15세미만","2021 년","414075","213300","200775","106.2","410659","211580","199079","106.3",
"경상남도","15세미만","2022 년","393584","202540","191044","106","390045","200756","189289","106.1",
"경상남도","15세미만","2023 년","372519","191937","180582","106.3","369095","190193","178902","106.3",
"경상남도","15~64세","2015 년","2401204","1268394","1132810","112","2314293","1205772","1108521","108.8",
"경상남도","15~64세","2016 년","2402826","1270045","1132781","112.1","2314355","1206913","1107442","109",
"경상남도","15~64세","2017 년","2392620","1262867","1129753","111.8","2305053","1202009","1103044","109",
"경상남도","15~64세","2018 년","2389014","1260611","1128403","111.7","2295582","1196641","1098941","108.9",
"경상남도","15~64세","2019 년","2373705","1254354","1119351","112.1","2272963","1185667","1087296","109",
"경상남도","15~64세","2020 년","2339798","1233435","1106363","111.5","2248164","1172716","1075448","109",
"경상남도","15~64세","2021 년","2298155","1210907","1087248","111.4","2211907","1154620","1057287","109.2",
"경상남도","15~64세","2022 년","2263285","1193729","1069556","111.6","2172923","1134128","1038795","109.2",
"경상남도","15~64세","2023 년","2244024","1189122","1054902","112.7","2133070","1112910","1020160","109.1",
"경상남도","65세이상","2015 년","453559","180699","272860","66.2","452232","180075","272157","66.2",
"경상남도","65세이상","2016 년","466946","188061","278885","67.4","465492","187413","278079","67.4",
"경상남도","65세이상","2017 년","490474","199985","290489","68.8","488894","199258","289636","68.8",
"경상남도","65세이상","2018 년","508948","209548","299400","70","507265","208791","298474","70",
"경상남도","65세이상","2019 년","532585","222130","310455","71.5","530671","221256","309415","71.5",
"경상남도","65세이상","2020 년","564903","237937","326966","72.8","562896","237077","325819","72.8",
"경상남도","65세이상","2021 년","593701","252546","341155","74","591529","251623","339906","74",
"경상남도","65세이상","2022 년","623960","268700","355260","75.6","621558","267672","353886","75.6",
"경상남도","65세이상","2023 년","654605","284839","369766","77","651748","283591","368157","77",
"경상남도","85세이상","2015 년","37944","8598","29346","29.3","37894","8583","29311","29.3",
"경상남도","85세이상","2016 년","40351","9148","31203","29.3","40300","9131","31169","29.3",
"경상남도","85세이상","2017 년","44698","10172","34526","29.5","44650","10159","34491","29.5",
"경상남도","85세이상","2018 년","48125","11096","37029","30","48082","11084","36998","30",
"경상남도","85세이상","2019 년","52778","12419","40359","30.8","52700","12392","40308","30.7",
"경상남도","85세이상","2020 년","57739","13920","43819","31.8","57677","13898","43779","31.7",
"경상남도","85세이상","2021 년","62920","15472","47448","32.6","62856","15454","47402","32.6",
"경상남도","85세이상","2022 년","66759","16750","50009","33.5","66694","16730","49964","33.5",
"경상남도","85세이상","2023 년","70179","17815","52364","34","70094","17792","52302","34",
"경상남도","평균연령","2015 년","40.7","39","42.4","","40.8","39.2","42.5","",
"경상남도","평균연령","2016 년","41.2","39.6","42.8","","41.3","39.7","42.9","",
"경상남도","평균연령","2017 년","41.8","40.2","43.4","","41.9","40.3","43.5","",
"경상남도","평균연령","2018 년","42.3","40.7","44","","42.5","40.9","44.1","",
"경상남도","평균연령","2019 년","42.9","41.3","44.6","","43.2","41.6","44.8","",
"경상남도","평균연령","2020 년","43.6","42","45.2","","43.8","42.3","45.4","",
"경상남도","평균연령","2021 년","44.3","42.7","45.9","","44.5","43","46.1","",
"경상남도","평균연령","2022 년","45","43.4","46.6","","45.2","43.7","46.8","",
"경상남도","평균연령","2023 년","45.6","44","47.3","","46","44.5","47.5","",
"경상남도","중위연령","2015 년","41.7","39.9","43.5","","42.1","40.5","43.7","",
"경상남도","중위연령","2016 년","42.3","40.5","44.1","","42.8","41.1","44.3","",
"경상남도","중위연령","2017 년","43.1","41.2","44.9","","43.5","41.9","45.1","",
"경상남도","중위연령","2018 년","43.7","41.8","45.6","","44.3","42.6","45.8","",
"경상남도","중위연령","2019 년","44.5","42.6","46.4","","45.1","43.4","46.7","",
"경상남도","중위연령","2020 년","45.4","43.5","47.2","","45.9","44.2","47.5","",
"경상남도","중위연령","2021 년","46.2","44.3","48.1","","46.8","45","48.4","",
"경상남도","중위연령","2022 년","47.1","45.1","48.9","","47.7","45.9","49.3","",
"경상남도","중위연령","2023 년","47.8","45.8","49.8","","48.6","46.9","50.2","",
"제주특별자치도","합계","2015 년","605619","304789","300830","101.3","590473","295875","294598","100.4",
"제주특별자치도","합계","2016 년","623332","314133","309199","101.6","605856","303939","301917","100.7",
"제주특별자치도","합계","2017 년","641757","324015","317742","102","621357","312363","308994","101.1",
"제주특별자치도","합계","2018 년","658282","333019","325263","102.4","632995","318135","314860","101",
"제주특별자치도","합계","2019 년","665048","336598","328450","102.5","637031","320102","316929","101",
"제주특별자치도","합계","2020 년","670858","338173","332685","101.6","644027","323004","321023","100.6",
"제주특별자치도","합계","2021 년","673107","338809","334298","101.3","647897","324521","323376","100.4",
"제주특별자치도","합계","2022 년","676375","340665","335710","101.5","650225","325322","324903","100.1",
"제주특별자치도","합계","2023 년","676767","341483","335284","101.8","647943","324115","323828","100.1",
"제주특별자치도","0~4세","2015 년","30280","15530","14750","105.3","30025","15402","14623","105.3",
"제주특별자치도","0~4세","2016 년","30639","15730","14909","105.5","30350","15569","14781","105.3",
"제주특별자치도","0~4세","2017 년","29813","15363","14450","106.3","29491","15192","14299","106.2",
"제주특별자치도","0~4세","2018 년","29154","15054","14100","106.8","28713","14823","13890","106.7",
"제주특별자치도","0~4세","2019 년","27919","14361","13558","105.9","27192","14014","13178","106.3",
"제주특별자치도","0~4세","2020 년","25968","13329","12639","105.5","25247","12991","12256","106",
"제주특별자치도","0~4세","2021 년","23856","12277","11579","106","23298","11996","11302","106.1",
"제주특별자치도","0~4세","2022 년","22178","11409","10769","105.9","21686","11170","10516","106.2",
"제주특별자치도","0~4세","2023 년","20225","10360","9865","105","19921","10204","9717","105",
"제주특별자치도","5~9세","2015 년","32147","16663","15484","107.6","31943","16559","15384","107.6",
"제주특별자치도","5~9세","2016 년","33262","17190","16072","107","33006","17061","15945","107",
"제주특별자치도","5~9세","2017 년","33995","17539","16456","106.6","33780","17437","16343","106.7",
"제주특별자치도","5~9세","2018 년","34673","17851","16822","106.1","34378","17707","16671","106.2",
"제주특별자치도","5~9세","2019 년","34975","18031","16944","106.4","34535","17793","16742","106.3",
"제주특별자치도","5~9세","2020 년","35270","18115","17155","105.6","34747","17834","16913","105.4",
"제주특별자치도","5~9세","2021 년","35130","18062","17068","105.8","34533","17744","16789","105.7",
"제주특별자치도","5~9세","2022 년","33691","17332","16359","105.9","33062","16996","16066","105.8",
"제주특별자치도","5~9세","2023 년","31550","16251","15299","106.2","31224","16081","15143","106.2",
"제주특별자치도","10~14세","2015 년","34463","18286","16177","113","34316","18219","16097","113.2",
"제주특별자치도","10~14세","2016 년","33393","17700","15693","112.8","33247","17626","15621","112.8",
"제주특별자치도","10~14세","2017 년","33940","17806","16134","110.4","33783","17728","16055","110.4",
"제주특별자치도","10~14세","2018 년","34064","17779","16285","109.2","33827","17657","16170","109.2",
"제주특별자치도","10~14세","2019 년","33921","17634","16287","108.3","33607","17485","16122","108.5",
"제주특별자치도","10~14세","2020 년","34738","17985","16753","107.4","34386","17803","16583","107.4",
"제주특별자치도","10~14세","2021 년","35844","18536","17308","107.1","35507","18375","17132","107.3",
"제주특별자치도","10~14세","2022 년","36142","18647","17495","106.6","35781","18473","17308","106.7",
"제주특별자치도","10~14세","2023 년","35915","18463","17452","105.8","35614","18303","17311","105.7",
"제주특별자치도","15~19세","2015 년","39846","20914","18932","110.5","39423","20687","18736","110.4",
"제주특별자치도","15~19세","2016 년","39089","20509","18580","110.4","38627","20264","18363","110.4",
"제주특별자치도","15~19세","2017 년","37604","19729","17875","110.4","37088","19479","17609","110.6",
"제주특별자치도","15~19세","2018 년","36701","19298","17403","110.9","36027","18959","17068","111.1",
"제주특별자치도","15~19세","2019 년","35120","18533","16587","111.7","34442","18165","16277","111.6",
"제주특별자치도","15~19세","2020 년","33279","17612","15667","112.4","32883","17411","15472","112.5",
"제주특별자치도","15~19세","2021 년","31909","16866","15043","112.1","31585","16695","14890","112.1",
"제주특별자치도","15~19세","2022 년","31981","16727","15254","109.7","31664","16552","15112","109.5",
"제주특별자치도","15~19세","2023 년","31828","16662","15166","109.9","31385","16411","14974","109.6",
"제주특별자치도","20~24세","2015 년","38656","20992","17664","118.8","36154","19520","16634","117.4",
"제주특별자치도","20~24세","2016 년","39452","21625","17827","121.3","36593","19881","16712","119",
"제주특별자치도","20~24세","2017 년","40351","22127","18224","121.4","37261","20197","17064","118.4",
"제주특별자치도","20~24세","2018 년","40705","22515","18190","123.8","36904","20012","16892","118.5",
"제주특별자치도","20~24세","2019 년","39681","21948","17733","123.8","35730","19414","16316","119",
"제주특별자치도","20~24세","2020 년","39918","21750","18168","119.7","36772","19810","16962","116.8",
"제주특별자치도","20~24세","2021 년","37303","20293","17010","119.3","34893","18884","16009","118",
"제주특별자치도","20~24세","2022 년","35138","19422","15716","123.6","32757","17914","14843","120.7",
"제주특별자치도","20~24세","2023 년","32869","18466","14403","128.2","30397","16732","13665","122.4",
"제주특별자치도","25~29세","2015 년","32472","17008","15464","110","29254","15130","14124","107.1",
"제주특별자치도","25~29세","2016 년","34342","17920","16422","109.1","30793","15854","14939","106.1",
"제주특별자치도","25~29세","2017 년","37087","19702","17385","113.3","33070","17252","15818","109.1",
"제주특별자치도","25~29세","2018 년","40788","21853","18935","115.4","35763","18549","17214","107.8",
"제주특별자치도","25~29세","2019 년","42615","23141","19474","118.8","37483","19645","17838","110.1",
"제주특별자치도","25~29세","2020 년","43494","23432","20062","116.8","38934","20414","18520","110.2",
"제주특별자치도","25~29세","2021 년","43738","23598","20140","117.2","39493","20728","18765","110.5",
"제주특별자치도","25~29세","2022 년","43432","23515","19917","118.1","38912","20330","18582","109.4",
"제주특별자치도","25~29세","2023 년","42176","23069","19107","120.7","37359","19629","17730","110.7",
"제주특별자치도","30~34세","2015 년","40974","21202","19772","107.2","38545","19642","18903","103.9",
"제주특별자치도","30~34세","2016 년","40097","20695","19402","106.7","37191","18929","18262","103.7",
"제주특별자치도","30~34세","2017 년","39400","20401","18999","107.4","35888","18358","17530","104.7",
"제주특별자치도","30~34세","2018 년","39187","20486","18701","109.5","34726","17809","16917","105.3",
"제주특별자치도","30~34세","2019 년","38640","20202","18438","109.6","33707","17229","16478","104.6",
"제주특별자치도","30~34세","2020 년","38651","20055","18596","107.8","33811","17242","16569","104.1",
"제주특별자치도","30~34세","2021 년","39245","20353","18892","107.7","34757","17669","17088","103.4",
"제주특별자치도","30~34세","2022 년","40658","21414","19244","111.3","36160","18529","17631","105.1",
"제주특별자치도","30~34세","2023 년","42680","22675","20005","113.3","37639","19309","18330","105.3",
"제주특별자치도","35~39세","2015 년","45034","23360","21674","107.8","43342","22194","21148","104.9",
"제주특별자치도","35~39세","2016 년","47616","24494","23122","105.9","45511","23106","22405","103.1",
"제주특별자치도","35~39세","2017 년","50475","25838","24637","104.9","47747","24216","23531","102.9",
"제주특별자치도","35~39세","2018 년","52990","27038","25952","104.2","49481","25024","24457","102.3",
"제주특별자치도","35~39세","2019 년","52071","26633","25438","104.7","48208","24407","23801","102.5",
"제주특별자치도","35~39세","2020 년","49911","25400","24511","103.6","45994","23155","22839","101.4",
"제주특별자치도","35~39세","2021 년","47315","23959","23356","102.6","43494","21759","21735","100.1",
"제주특별자치도","35~39세","2022 년","44708","22655","22053","102.7","40779","20342","20437","99.5",
"제주특별자치도","35~39세","2023 년","42494","21727","20767","104.6","37921","18982","18939","100.2",
"제주특별자치도","40~44세","2015 년","53618","27818","25800","107.8","52406","27008","25398","106.3",
"제주특별자치도","40~44세","2016 년","52708","27558","25150","109.6","51346","26696","24650","108.3",
"제주특별자치도","40~44세","2017 년","52454","27370","25084","109.1","50724","26411","24313","108.6",
"제주특별자치도","40~44세","2018 년","51822","26995","24827","108.7","49601","25817","23784","108.5",
"제주특별자치도","40~44세","2019 년","51564","26618","24946","106.7","48919","25241","23678","106.6",
"제주특별자치도","40~44세","2020 년","52624","26917","25707","104.7","49813","25490","24323","104.8",
"제주특별자치도","40~44세","2021 년","54451","27548","26903","102.4","51568","26060","25508","102.2",
"제주특별자치도","40~44세","2022 년","56280","28378","27902","101.7","53143","26692","26451","100.9",
"제주특별자치도","40~44세","2023 년","57168","28793","28375","101.5","53569","26832","26737","100.4",
"제주특별자치도","45~49세","2015 년","52615","27499","25116","109.5","51685","26989","24696","109.3",
"제주특별자치도","45~49세","2016 년","55643","29010","26633","108.9","54541","28382","26159","108.5",
"제주특별자치도","45~49세","2017 년","58762","30640","28122","109","57416","29902","27514","108.7",
"제주특별자치도","45~49세","2018 년","59931","31155","28776","108.3","58362","30269","28093","107.7",
"제주특별자치도","45~49세","2019 년","60650","31477","29173","107.9","58827","30456","28371","107.3",
"제주특별자치도","45~49세","2020 년","59453","30777","28676","107.3","57595","29819","27776","107.4",
"제주특별자치도","45~49세","2021 년","56970","29465","27505","107.1","55104","28545","26559","107.5",
"제주특별자치도","45~49세","2022 년","55551","28692","26859","106.8","53604","27754","25850","107.4",
"제주특별자치도","45~49세","2023 년","53840","27785","26055","106.6","51524","26685","24839","107.4",
"제주특별자치도","50~54세","2015 년","48312","24908","23404","106.4","47594","24569","23025","106.7",
"제주특별자치도","50~54세","2016 년","50250","26177","24073","108.7","49413","25781","23632","109.1",
"제주특별자치도","50~54세","2017 년","51683","26967","24716","109.1","50731","26507","24224","109.4",
"제주특별자치도","50~54세","2018 년","53139","27792","25347","109.6","52096","27253","24843","109.7",
"제주특별자치도","50~54세","2019 년","55216","28916","26300","109.9","53977","28229","25748","109.6",
"제주특별자치도","50~54세","2020 년","57221","29764","27457","108.4","55950","29131","26819","108.6",
"제주특별자치도","50~54세","2021 년","59330","30681","28649","107.1","58024","29984","28040","106.9",
"제주특별자치도","50~54세","2022 년","61140","31480","29660","106.1","59713","30744","28969","106.1",
"제주특별자치도","50~54세","2023 년","61806","31725","30081","105.5","60082","30801","29281","105.2",
"제주특별자치도","55~59세","2015 년","43267","21966","21301","103.1","42720","21721","20999","103.4",
"제주특별자치도","55~59세","2016 년","46084","23355","22729","102.8","45484","23081","22403","103",
"제주특별자치도","55~59세","2017 년","48614","24800","23814","104.1","47911","24471","23440","104.4",
"제주특별자치도","55~59세","2018 년","50973","25959","25014","103.8","50182","25561","24621","103.8",
"제주특별자치도","55~59세","2019 년","51721","26431","25290","104.5","50806","25984","24822","104.7",
"제주특별자치도","55~59세","2020 년","51676","26510","25166","105.3","50719","26067","24652","105.7",
"제주특별자치도","55~59세","2021 년","52278","27011","25267","106.9","51342","26573","24769","107.3",
"제주특별자치도","55~59세","2022 년","53149","27488","25661","107.1","52190","27025","25165","107.4",
"제주특별자치도","55~59세","2023 년","54353","28074","26279","106.8","53254","27542","25712","107.1",
"제주특별자치도","60~64세","2015 년","30467","14964","15503","96.5","30041","14773","15268","96.8",
"제주특별자치도","60~64세","2016 년","34033","16786","17247","97.3","33519","16558","16961","97.6",
"제주특별자치도","60~64세","2017 년","37152","18463","18689","98.8","36545","18177","18368","99",
"제주특별자치도","60~64세","2018 년","40709","20441","20268","100.9","40067","20157","19910","101.2",
"제주특별자치도","60~64세","2019 년","43485","21772","21713","100.3","42832","21481","21351","100.6",
"제주특별자치도","60~64세","2020 년","45675","22926","22749","100.8","44965","22607","22358","101.1",
"제주특별자치도","60~64세","2021 년","47821","23988","23833","100.7","47173","23700","23473","101",
"제주특별자치도","60~64세","2022 년","49309","24679","24630","100.2","48629","24372","24257","100.5",
"제주특별자치도","60~64세","2023 년","51572","25904","25668","100.9","50770","25530","25240","101.1",
"제주특별자치도","65~69세","2015 년","25221","12127","13094","92.6","25007","12025","12982","92.6",
"제주특별자치도","65~69세","2016 년","25877","12487","13390","93.3","25629","12375","13254","93.4",
"제주특별자치도","65~69세","2017 년","26604","12867","13737","93.7","26334","12754","13580","93.9",
"제주특별자치도","65~69세","2018 년","26678","12801","13877","92.2","26370","12668","13702","92.5",
"제주특별자치도","65~69세","2019 년","28149","13592","14557","93.4","27779","13415","14364","93.4",
"제주특별자치도","65~69세","2020 년","31279","15177","16102","94.3","30856","14975","15881","94.3",
"제주특별자치도","65~69세","2021 년","34031","16575","17456","95","33601","16375","17226","95.1",
"제주특별자치도","65~69세","2022 년","36645","17893","18752","95.4","36196","17673","18523","95.4",
"제주특별자치도","65~69세","2023 년","39833","19632","20201","97.2","39282","19375","19907","97.3",
"제주특별자치도","70~74세","2015 년","21340","9729","11611","83.8","21236","9673","11563","83.7",
"제주특별자치도","70~74세","2016 년","21536","9928","11608","85.5","21431","9868","11563","85.3",
"제주특별자치도","70~74세","2017 년","22178","10284","11894","86.5","22064","10216","11848","86.2",
"제주특별자치도","70~74세","2018 년","23414","10997","12417","88.6","23267","10920","12347","88.4",
"제주특별자치도","70~74세","2019 년","24055","11316","12739","88.8","23874","11227","12647","88.8",
"제주특별자치도","70~74세","2020 년","24756","11584","13172","87.9","24555","11485","13070","87.9",
"제주특별자치도","70~74세","2021 년","25121","11822","13299","88.9","24909","11727","13182","89",
"제주특별자치도","70~74세","2022 년","25684","12112","13572","89.2","25439","12021","13418","89.6",
"제주특별자치도","70~74세","2023 년","25588","11957","13631","87.7","25340","11851","13489","87.9",
"제주특별자치도","75~79세","2015 년","17225","6821","10404","65.6","17159","6793","10366","65.5",
"제주특별자치도","75~79세","2016 년","18203","7353","10850","67.8","18136","7325","10811","67.8",
"제주특별자치도","75~79세","2017 년","19070","7883","11187","70.5","19022","7866","11156","70.5",
"제주특별자치도","75~79세","2018 년","19337","8111","11226","72.3","19281","8086","11195","72.2",
"제주특별자치도","75~79세","2019 년","19572","8347","11225","74.4","19496","8310","11186","74.3",
"제주특별자치도","75~79세","2020 년","19766","8589","11177","76.8","19682","8547","11135","76.8",
"제주특별자치도","75~79세","2021 년","19882","8726","11156","78.2","19802","8686","11116","78.1",
"제주특별자치도","75~79세","2022 년","20415","9041","11374","79.5","20307","8981","11326","79.3",
"제주특별자치도","75~79세","2023 년","21497","9670","11827","81.8","21381","9617","11764","81.7",
"제주특별자치도","80~84세","2015 년","11706","3666","8040","45.6","11675","3649","8026","45.5",
"제주특별자치도","80~84세","2016 년","12566","4089","8477","48.2","12528","4071","8457","48.1",
"제주특별자치도","80~84세","2017 년","13232","4486","8746","51.3","13189","4463","8726","51.1",
"제주특별자치도","80~84세","2018 년","13658","4818","8840","54.5","13620","4798","8822","54.4",
"제주특별자치도","80~84세","2019 년","14187","5118","9069","56.4","14143","5096","9047","56.3",
"제주특별자치도","80~84세","2020 년","14699","5375","9324","57.6","14662","5360","9302","57.6",
"제주특별자치도","80~84세","2021 년","15504","5800","9704","59.8","15464","5783","9681","59.7",
"제주특별자치도","80~84세","2022 년","16206","6210","9996","62.1","16165","6195","9970","62.1",
"제주특별자치도","80~84세","2023 년","16402","6340","10062","63","16345","6313","10032","62.9",
"제주특별자치도","85~89세","2015 년","5026","976","4050","24.1","5008","966","4042","23.9",
"제주특별자치도","85~89세","2016 년","5578","1145","4433","25.8","5559","1136","4423","25.7",
"제주특별자치도","85~89세","2017 년","6265","1368","4897","27.9","6247","1359","4888","27.8",
"제주특별자치도","85~89세","2018 년","7173","1691","5482","30.8","7153","1684","5469","30.8",
"제주특별자치도","85~89세","2019 년","8012","2057","5955","34.5","7989","2045","5944","34.4",
"제주특별자치도","85~89세","2020 년","8548","2327","6221","37.4","8530","2316","6214","37.3",
"제주특별자치도","85~89세","2021 년","9177","2613","6564","39.8","9155","2603","6552","39.7",
"제주특별자치도","85~89세","2022 년","9553","2826","6727","42","9529","2815","6714","41.9",
"제주특별자치도","85~89세","2023 년","9951","3058","6893","44.4","9924","3049","6875","44.3",
"제주특별자치도","90~94세","2015 년","2287","296","1991","14.9","2282","295","1987","14.8",
"제주특별자치도","90~94세","2016 년","2195","313","1882","16.6","2188","310","1878","16.5",
"제주특별자치도","90~94세","2017 년","2182","294","1888","15.6","2174","293","1881","15.6",
"제주특별자치도","90~94세","2018 년","2030","288","1742","16.5","2023","286","1737","16.5",
"제주특별자치도","90~94세","2019 년","2416","375","2041","18.4","2409","371","2038","18.2",
"제주특별자치도","90~94세","2020 년","2871","462","2409","19.2","2869","461","2408","19.1",
"제주특별자치도","90~94세","2021 년","3164","547","2617","20.9","3163","547","2616","20.9",
"제주특별자치도","90~94세","2022 년","3547","667","2880","23.2","3544","667","2877","23.2",
"제주특별자치도","90~94세","2023 년","4010","785","3225","24.3","4004","783","3221","24.3",
"제주특별자치도","95~99세","2015 년","564","56","508","11","559","53","506","10.5",
"제주특별자치도","95~99세","2016 년","670","63","607","10.4","665","60","605","9.9",
"제주특별자치도","95~99세","2017 년","791","84","707","11.9","787","81","706","11.5",
"제주특별자치도","95~99세","2018 년","1052","92","960","9.6","1051","92","959","9.6",
"제주특별자치도","95~99세","2019 년","958","88","870","10.1","957","88","869","10.1",
"제주특별자치도","95~99세","2020 년","907","77","830","9.3","904","77","827","9.3",
"제주특별자치도","95~99세","2021 년","870","78","792","9.8","865","78","787","9.9",
"제주특별자치도","95~99세","2022 년","772","69","703","9.8","769","68","701","9.7",
"제주특별자치도","95~99세","2023 년","734","72","662","10.9","733","72","661","10.9",
"제주특별자치도","100세이상","2015 년","99","8","91","8.8","99","8","91","8.8",
"제주특별자치도","100세이상","2016 년","99","6","93","6.5","99","6","93","6.5",
"제주특별자치도","100세이상","2017 년","105","X","101","4","105","X","101","4",
"제주특별자치도","100세이상","2018 년","104","5","99","5.1","103","X","99","4",
"제주특별자치도","100세이상","2019 년","121","8","113","7.1","119","7","112","6.3",
"제주특별자치도","100세이상","2020 년","154","10","144","6.9","153","9","144","6.3",
"제주특별자치도","100세이상","2021 년","168","11","157","7","167","10","157","6.4",
"제주특별자치도","100세이상","2022 년","196","9","187","4.8","196","9","187","4.8",
"제주특별자치도","100세이상","2023 년","276","15","261","5.7","275","14","261","5.4",
"제주특별자치도","15세미만","2015 년","96890","50479","46411","108.8","96284","50180","46104","108.8",
"제주특별자치도","15세미만","2016 년","97294","50620","46674","108.5","96603","50256","46347","108.4",
"제주특별자치도","15세미만","2017 년","97748","50708","47040","107.8","97054","50357","46697","107.8",
"제주특별자치도","15세미만","2018 년","97891","50684","47207","107.4","96918","50187","46731","107.4",
"제주특별자치도","15세미만","2019 년","96815","50026","46789","106.9","95334","49292","46042","107.1",
"제주특별자치도","15세미만","2020 년","95976","49429","46547","106.2","94380","48628","45752","106.3",
"제주특별자치도","15세미만","2021 년","94830","48875","45955","106.4","93338","48115","45223","106.4",
"제주특별자치도","15세미만","2022 년","92011","47388","44623","106.2","90529","46639","43890","106.3",
"제주특별자치도","15세미만","2023 년","87690","45074","42616","105.8","86759","44588","42171","105.7",
"제주특별자치도","15~64세","2015 년","425261","220631","204630","107.8","411164","212233","198931","106.7",
"제주특별자치도","15~64세","2016 년","439314","228129","211185","108","423018","218532","204486","106.9",
"제주특별자치도","15~64세","2017 년","453582","236037","217545","108.5","434381","224970","209411","107.4",
"제주특별자치도","15~64세","2018 년","466945","243532","223413","109","443209","229410","213799","107.3",
"제주특별자치도","15~64세","2019 년","470763","245671","225092","109.1","444931","230251","214680","107.3",
"제주특별자치도","15~64세","2020 년","471902","245143","226759","108.1","447436","231146","216290","106.9",
"제주특별자치도","15~64세","2021 년","470360","243762","226598","107.6","447433","230597","216836","106.3",
"제주특별자치도","15~64세","2022 년","471346","244450","226896","107.7","447551","230254","217297","106",
"제주특별자치도","15~64세","2023 년","470786","244880","225906","108.4","443900","228453","215447","106",
"제주특별자치도","65세이상","2015 년","83468","33679","49789","67.6","83025","33462","49563","67.5",
"제주특별자치도","65세이상","2016 년","86724","35384","51340","68.9","86235","35151","51084","68.8",
"제주특별자치도","65세이상","2017 년","90427","37270","53157","70.1","89922","37036","52886","70",
"제주특별자치도","65세이상","2018 년","93446","38803","54643","71","92868","38538","54330","70.9",
"제주특별자치도","65세이상","2019 년","97470","40901","56569","72.3","96766","40559","56207","72.2",
"제주특별자치도","65세이상","2020 년","102980","43601","59379","73.4","102211","43230","58981","73.3",
"제주특별자치도","65세이상","2021 년","107917","46172","61745","74.8","107126","45809","61317","74.7",
"제주특별자치도","65세이상","2022 년","113018","48827","64191","76.1","112145","48429","63716","76",
"제주특별자치도","65세이상","2023 년","118291","51529","66762","77.2","117284","51074","66210","77.1",
"제주특별자치도","85세이상","2015 년","7976","1336","6640","20.1","7948","1322","6626","20",
"제주특별자치도","85세이상","2016 년","8542","1527","7015","21.8","8511","1512","6999","21.6",
"제주특별자치도","85세이상","2017 년","9343","1750","7593","23","9313","1737","7576","22.9",
"제주특별자치도","85세이상","2018 년","10359","2076","8283","25.1","10330","2066","8264","25",
"제주특별자치도","85세이상","2019 년","11507","2528","8979","28.2","11474","2511","8963","28",
"제주특별자치도","85세이상","2020 년","12480","2876","9604","29.9","12456","2863","9593","29.8",
"제주특별자치도","85세이상","2021 년","13379","3249","10130","32.1","13350","3238","10112","32",
"제주특별자치도","85세이상","2022 년","14068","3571","10497","34","14038","3559","10479","34",
"제주특별자치도","85세이상","2023 년","14971","3930","11041","35.6","14936","3918","11018","35.6",
"제주특별자치도","평균연령","2015 년","39.9","38.5","41.4","","40.1","38.6","41.6","",
"제주특별자치도","평균연령","2016 년","40.4","38.9","41.8","","40.5","39.1","42","",
"제주특별자치도","평균연령","2017 년","40.8","39.4","42.2","","41","39.6","42.3","",
"제주특별자치도","평균연령","2018 년","41.1","39.8","42.5","","41.4","40.1","42.7","",
"제주특별자치도","평균연령","2019 년","41.6","40.3","43","","41.9","40.6","43.2","",
"제주특별자치도","평균연령","2020 년","42.1","40.8","43.4","","42.3","41.1","43.6","",
"제주특별자치도","평균연령","2021 년","42.6","41.3","43.9","","42.9","41.6","44.1","",
"제주특별자치도","평균연령","2022 년","43.1","41.9","44.4","","43.4","42.2","44.7","",
"제주특별자치도","평균연령","2023 년","43.8","42.5","45.1","","44.1","42.9","45.3","",
"제주특별자치도","중위연령","2015 년","41","39.7","42.2","","41.3","40.1","42.4","",
"제주특별자치도","중위연령","2016 년","41.4","40.2","42.7","","41.9","40.8","43","",
"제주특별자치도","중위연령","2017 년","41.9","40.7","43.1","","42.4","41.3","43.5","",
"제주특별자치도","중위연령","2018 년","42.1","41","43.4","","42.8","41.8","43.9","",
"제주특별자치도","중위연령","2019 년","42.7","41.5","44","","43.5","42.4","44.6","",
"제주특별자치도","중위연령","2020 년","43.2","42","44.4","","43.9","42.9","45","",
"제주특별자치도","중위연령","2021 년","43.8","42.7","45","","44.5","43.5","45.5","",
"제주특별자치도","중위연령","2022 년","44.4","43.3","45.6","","45.1","44.1","46.1","",
"제주특별자치도","중위연령","2023 년","45.1","44","46.4","","45.9","44.9","47","",
